icighc	i c i g h c	1791
hhic	h h i c	1275
cj	c j	780
cejjic	c e j j i c	254
cf	c f	220
fjiice	f j i i c e	189
ccc	c c c	183
jgdji	j g d j i	75
cg	c g	71
h	h	68
bbg	b b g	67
ee	e e	56
dajdfhic	d a j d f h i c	55
ghh	g h h	55
ahc	a h c	53
jcc	j c c	37
jah	j a h	35
ajhch	a j h c h	35
hbdc	h b d c	33
ihe	i h e	28
cdgcccc	c d g c c c c	26
edhfah	e d h f a h	25
acf	a c f	25
gcbcifje	g c b c i f j e	25
cc	c c	25
cbei	c b e i	24
hja	h j a	23
ghjc	g h j c	23
jhc	j h c	22
ihhfd	i h h f d	22
fch	f c h	22
jfffhh	j f f f h h	22
ccj	c c j	22
fcdje	f c d j e	21
agihh	a g i h h	20
ecahi	e c a h i	20
bch	b c h	19
hbejhihh	h b e j h i h h	19
cchhj	c c h h j	19
ge	g e	18
agcei	a g c e i	17
fegca	f e g c a	17
cdaac	c d a a c	17
eji	e j i	17
ffhcheh	f f h c h e h	16
bcj	b c j	16
ehca	e h c a	15
cjahj	c j a h j	15
jcicjj	j c i c j j	15
gacjbj	g a c j b j	15
jjdehi	j j d e h i	15
jdec	j d e c	14
bhihg	b h i h g	14
gigccdhj	g i g c c d h j	14
bcig	b c i g	14
hdihj	h d i h j	13
abfgchc	a b f g c h c	13
cec	c e c	13
gjhcb	g j h c b	13
cfffie	c f f f i e	12
ijb	i j b	12
dcje	d c j e	12
biici	b i i c i	11
gggcci	g g g c c i	11
cfcf	c f c f	11
abifegc	a b i f e g c	11
cihcd	c i h c d	11
higefhde	h i g e f h d e	11
idddi	i d d d i	10
fdi	f d i	10
ecjdc	e c j d c	10
eahfdhc	e a h f d h c	10
hgcdd	h g c d d	10
gha	g h a	9
djch	d j c h	9
cfff	c f f f	9
adacdg	a d a c d g	9
jcbjicg	j c b j i c g	9
ddhc	d d h c	9
ejh	e j h	8
jcdjcfjg	j c d j c f j g	8
jeh	j e h	8
jibgdj	j i b g d j	8
hgji	h g j i	8
chjhed	c h j h e d	8
jij	j i j	8
adh	a d h	7
ac	a c	7
bhd	b h d	7
cgf	c g f	7
ecgib	e c g i b	7
caj	c a j	7
idgighf	i d g i g h f	7
gajeii	g a j e i i	7
djjj	d j j j	7
bh	b h	7
hff	h f f	6
eb	e b	6
fhgjeag	f h g j e a g	6
gji	g j i	6
fcfhic	f c f h i c	6
eiih	e i i h	6
bbchcegc	b b c h c e g c	6
cbcce	c b c c e	6
jhcjhch	j h c j h c h	6
jj	j j	6
iej	i e j	6
achci	a c h c i	6
cddb	c d d b	6
febecbea	f e b e c b e a	5
digei	d i g e i	5
bbcc	b b c c	5
ebci	e b c i	5
adehegd	a d e h e g d	5
dfaecb	d f a e c b	5
babia	b a b i a	5
bhjaijig	b h j a i j i g	5
jajehe	j a j e h e	5
gi	g i	5
adfg	a d f g	5
fhhc	f h h c	5
ahh	a h h	5
bgeabca	b g e a b c a	5
dbi	d b i	5
jbe	j b e	5
biiccgg	b i i c c g g	5
hebh	h e b h	5
aeih	a e i h	5
hjiec	h j i e c	4
behadg	b e h a d g	4
gcdcg	g c d c g	4
jbhachec	j b h a c h e c	4
bcbcchc	b c b c c h c	4
jjjj	j j j j	4
hahdhic	h a h d h i c	4
bih	b i h	4
iich	i i c h	4
ajbc	a j b c	4
fgeh	f g e h	4
jiicheca	j i i c h e c a	4
hgfc	h g f c	4
gbjd	g b j d	4
bef	b e f	4
ahej	a h e j	4
gac	g a c	4
hdf	h d f	4
hefgcb	h e f g c b	4
jhfifc	j h f i f c	4
ababj	a b a b j	4
gihbii	g i h b i i	4
fcghcc	f c g h c c	4
ddcc	d d c c	4
iacjcc	i a c j c c	4
gfbjjb	g f b j j b	4
daef	d a e f	4
gjee	g j e e	4
iegdheee	i e g d h e e e	4
hjeji	h j e j i	4
fieh	f i e h	4
dbeig	d b e i g	4
idaihc	i d a i h c	4
aibc	a i b c	4
hcdebj	h c d e b j	4
ahdghe	a h d g h e	4
addcf	a d d c f	3
ibbce	i b b c e	3
fbaihh	f b a i h h	3
ccg	c c g	3
jhj	j h j	3
bjb	b j b	3
cffhh	c f f h h	3
eci	e c i	3
bjfi	b j f i	3
igahe	i g a h e	3
gbdd	g b d d	3
geb	g e b	3
bacgajea	b a c g a j e a	3
jcabdic	j c a b d i c	3
hbc	h b c	3
ceacffeh	c e a c f f e h	3
bgge	b g g e	3
idibij	i d i b i j	3
didhch	d i d h c h	3
hibec	h i b e c	3
ehfg	e h f g	3
ach	a c h	3
gfbfj	g f b f j	3
cecjh	c e c j h	3
fdhhiaag	f d h h i a a g	3
ab	a b	3
icidbh	i c i d b h	3
hj	h j	3
jjadh	j j a d h	3
bgcihcd	b g c i h c d	3
ebfhh	e b f h h	3
eehjia	e e h j i a	3
che	c h e	3
gdf	g d f	3
faccf	f a c c f	3
jghccgg	j g h c c g g	3
cagcbhi	c a g c b h i	3
jfccci	j f c c c i	3
dbfecag	d b f e c a g	3
hbjc	h b j c	3
hgeaiih	h g e a i i h	3
didchf	d i d c h f	3
gdi	g d i	3
edgbci	e d g b c i	3
adjgab	a d j g a b	3
efjcjiad	e f j c j i a d	2
ebb	e b b	2
iajjifg	i a j j i f g	2
hbhjbdjb	h b h j b d j b	2
igifj	i g i f j	2
figidj	f i g i d j	2
jdeccic	j d e c c i c	2
haebe	h a e b e	2
bdjgj	b d j g j	2
gfah	g f a h	2
iha	i h a	2
iicehec	i i c e h e c	2
cfegeg	c f e g e g	2
hae	h a e	2
dig	d i g	2
dbfhbj	d b f h b j	2
ecc	e c c	2
jhadffi	j h a d f f i	2
jjcecf	j j c e c f	2
eejcja	e e j c j a	2
igch	i g c h	2
bbidi	b b i d i	2
cjeejh	c j e e j h	2
fbahj	f b a h j	2
jhcdbh	j h c d b h	2
eagcdej	e a g c d e j	2
iccghfb	i c c g h f b	2
gigaheih	g i g a h e i h	2
bfgi	b f g i	2
ggedfhh	g g e d f h h	2
abcef	a b c e f	2
ihgfehe	i h g f e h e	2
cdaigccg	c d a i g c c g	2
bajheab	b a j h e a b	2
hiefi	h i e f i	2
dgfahi	d g f a h i	2
jiijeh	j i i j e h	2
jface	j f a c e	2
iecdhfj	i e c d h f j	2
dbhjh	d b h j h	2
gjacdcga	g j a c d c g a	2
dij	d i j	2
efgcce	e f g c c e	2
ibjcibc	i b j c i b c	2
dechgib	d e c h g i b	2
adj	a d j	2
iiacbhe	i i a c b h e	2
fijgcaab	f i j g c a a b	2
fdijccji	f d i j c c j i	2
ciaeh	c i a e h	2
dafjhhc	d a f j h h c	2
daib	d a i b	2
efaabjih	e f a a b j i h	2
hgfdjh	h g f d j h	2
cggh	c g g h	2
ejjf	e j j f	2
cbhjefj	c b h j e f j	2
cbgcjef	c b g c j e f	2
agi	a g i	2
ieahh	i e a h h	2
bdac	b d a c	2
ejih	e j i h	2
cdfdb	c d f d b	2
bfcihi	b f c i h i	2
bdhgchd	b d h g c h d	2
jgj	j g j	2
ejheheg	e j h e h e g	2
affaa	a f f a a	2
iadhj	i a d h j	2
fecbj	f e c b j	2
dcccj	d c c c j	2
jghich	j g h i c h	2
idij	i d i j	2
fgehijac	f g e h i j a c	2
bfj	b f j	2
jbfjf	j b f j f	2
iad	i a d	2
jaheiid	j a h e i i d	2
gcc	g c c	2
bghahfcb	b g h a h f c b	2
djffgf	d j f f g f	2
ecdi	e c d i	2
dgii	d g i i	2
abide	a b i d e	2
ici	i c i	2
cdfdjh	c d f d j h	2
gedgdihg	g e d g d i h g	2
db	d b	2
abahb	a b a h b	2
jchccj	j c h c c j	2
ecd	e c d	2
fdd	f d d	2
baaa	b a a a	2
ghgj	g h g j	2
caccg	c a c c g	2
ddbhahg	d d b h a h g	2
dhi	d h i	2
ibcdfe	i b c d f e	2
gaaddadi	g a a d d a d i	2
iidjh	i i d j h	2
ejdcii	e j d c i i	2
hbf	h b f	2
jcahh	j c a h h	2
fejch	f e j c h	2
hcihb	h c i h b	2
hbh	h b h	2
hhdc	h h d c	2
decgfed	d e c g f e d	2
hhd	h h d	2
aif	a i f	2
dgjci	d g j c i	2
fcjah	f c j a h	2
gjchj	g j c h j	2
jbcehgdc	j b c e h g d c	2
gjgfjeh	g j g f j e h	2
jfa	j f a	2
aefc	a e f c	2
ahcch	a h c c h	2
ebijhh	e b i j h h	2
bjje	b j j e	2
bfdijh	b f d i j h	2
feje	f e j e	2
igdd	i g d d	2
hcdfjhgf	h c d f j h g f	2
af	a f	2
ghgcefc	g h g c e f c	2
dfhjddfb	d f h j d d f b	2
deei	d e e i	2
adiei	a d i e i	2
hdee	h d e e	2
dgea	d g e a	2
ajc	a j c	2
jefdgb	j e f d g b	2
gjdieehb	g j d i e e h b	2
fccch	f c c c h	2
ghbeghdf	g h b e g h d f	2
bb	b b	2
bifjfjgi	b i f j f j g i	2
fdcdchih	f d c d c h i h	2
egja	e g j a	2
gfj	g f j	2
iffjiee	i f f j i e e	2
fgi	f g i	2
egebhc	e g e b h c	2
haihcadd	h a i h c a d d	2
jhg	j h g	2
ggaj	g g a j	2
dfiebc	d f i e b c	2
abaj	a b a j	2
jfcj	j f c j	2
ciejja	c i e j j a	2
fcachhdc	f c a c h h d c	2
agbhej	a g b h e j	2
daijei	d a i j e i	2
cjbbi	c j b b i	2
daigdgdd	d a i g d g d d	2
fcgjh	f c g j h	2
jbhchjh	j b h c h j h	2
fdb	f d b	2
hcchi	h c c h i	2
cdbibi	c d b i b i	2
dbbcecj	d b b c e c j	2
cdgfcejj	c d g f c e j j	2
fdbcif	f d b c i f	2
ehbig	e h b i g	2
ifdjhi	i f d j h i	2
hfcefcdj	h f c e f c d j	2
gbafcc	g b a f c c	2
ijjfchi	i j j f c h i	2
jbicjg	j b i c j g	2
idhej	i d h e j	2
chdbhcb	c h d b h c b	2
cgeagf	c g e a g f	2
dhabceh	d h a b c e h	2
chbca	c h b c a	2
fbjj	f b j j	2
cbchca	c b c h c a	2
chgcg	c h g c g	2
fhihbf	f h i h b f	1
cjfjf	c j f j f	1
bcbiec	b c b i e c	1
eech	e e c h	1
ededdd	e d e d d d	1
fag	f a g	1
gcceih	g c c e i h	1
gabjaae	g a b j a a e	1
fjibh	f j i b h	1
jhh	j h h	1
jga	j g a	1
aahbj	a a h b j	1
jbaca	j b a c a	1
hgieb	h g i e b	1
fjh	f j h	1
ibhjc	i b h j c	1
gfjgfceg	g f j g f c e g	1
jaajfggh	j a a j f g g h	1
ijge	i j g e	1
dbifif	d b i f i f	1
jedcd	j e d c d	1
ejbccdaf	e j b c c d a f	1
cdeedia	c d e e d i a	1
dfggi	d f g g i	1
debcfjh	d e b c f j h	1
fccdgjc	f c c d g j c	1
edcf	e d c f	1
dicii	d i c i i	1
dfbbjc	d f b b j c	1
bejfagi	b e j f a g i	1
jjdjgcg	j j d j g c g	1
gdadhhaf	g d a d h h a f	1
gbg	g b g	1
gga	g g a	1
fjdj	f j d j	1
ghacj	g h a c j	1
iij	i i j	1
jcibdi	j c i b d i	1
cibic	c i b i c	1
ddjjj	d d j j j	1
jdiehd	j d i e h d	1
adhgh	a d h g h	1
aebgbf	a e b g b f	1
jjhjbgb	j j h j b g b	1
fcggdci	f c g g d c i	1
bhei	b h e i	1
cdffjfgc	c d f f j f g c	1
egdiei	e g d i e i	1
cdh	c d h	1
jcdhf	j c d h f	1
higai	h i g a i	1
hfbgc	h f b g c	1
cijiicg	c i j i i c g	1
bgiieh	b g i i e h	1
bac	b a c	1
eiadi	e i a d i	1
ghbd	g h b d	1
idejcgi	i d e j c g i	1
dhcejdj	d h c e j d j	1
ehegfh	e h e g f h	1
eebh	e e b h	1
bhac	b h a c	1
gdcdccc	g d c d c c c	1
aeab	a e a b	1
gcjge	g c j g e	1
ifdbff	i f d b f f	1
dea	d e a	1
djbgbcch	d j b g b c c h	1
ife	i f e	1
gdeid	g d e i d	1
cdbebbae	c d b e b b a e	1
dfjjahcd	d f j j a h c d	1
jibiih	j i b i i h	1
hacic	h a c i c	1
jbdec	j b d e c	1
bbhhhehg	b b h h h e h g	1
fbe	f b e	1
ghfiac	g h f i a c	1
gfjbc	g f j b c	1
hcgghea	h c g g h e a	1
daibic	d a i b i c	1
ceb	c e b	1
iahghee	i a h g h e e	1
hghaajfh	h g h a a j f h	1
dbhhh	d b h h h	1
eedc	e e d c	1
gedjbj	g e d j b j	1
geccbdcd	g e c c b d c d	1
edg	e d g	1
ghede	g h e d e	1
biajg	b i a j g	1
ebghfe	e b g h f e	1
hfhdj	h f h d j	1
fbhafch	f b h a f c h	1
chch	c h c h	1
bci	b c i	1
diadfjj	d i a d f j j	1
abjfj	a b j f j	1
dddicc	d d d i c c	1
bjfchi	b j f c h i	1
fc	f c	1
igifbc	i g i f b c	1
dic	d i c	1
bdjehgjg	b d j e h g j g	1
gdaidia	g d a i d i a	1
ebejbhjh	e b e j b h j h	1
faec	f a e c	1
ifhbbf	i f h b b f	1
dahf	d a h f	1
aaaj	a a a j	1
jaih	j a i h	1
hjdc	h j d c	1
jadge	j a d g e	1
dbic	d b i c	1
heagc	h e a g c	1
fbjfa	f b j f a	1
gagi	g a g i	1
fchjhcad	f c h j h c a d	1
gghhjfi	g g h h j f i	1
afa	a f a	1
cbjebc	c b j e b c	1
hchh	h c h h	1
agb	a g b	1
gccc	g c c c	1
jfcidbh	j f c i d b h	1
bdchee	b d c h e e	1
beefjhd	b e e f j h d	1
dfadbhbg	d f a d b h b g	1
feaa	f e a a	1
djdc	d j d c	1
efd	e f d	1
ghcjida	g h c j i d a	1
ddac	d d a c	1
jfca	j f c a	1
jeigbddj	j e i g b d d j	1
ijjc	i j j c	1
iabj	i a b j	1
bfdfhcif	b f d f h c i f	1
ghbcf	g h b c f	1
bbgejaig	b b g e j a i g	1
bgihb	b g i h b	1
adcec	a d c e c	1
eaj	e a j	1
ahhdih	a h h d i h	1
ahbghd	a h b g h d	1
gbcddcef	g b c d d c e f	1
dabfijf	d a b f i j f	1
dicc	d i c c	1
hgje	h g j e	1
ibbefd	i b b e f d	1
dgeici	d g e i c i	1
gddhiih	g d d h i i h	1
hciicei	h c i i c e i	1
ieg	i e g	1
hegcfdhf	h e g c f d h f	1
bdechifc	b d e c h i f c	1
dfjiggh	d f j i g g h	1
fghba	f g h b a	1
fcccc	f c c c c	1
hfh	h f h	1
cacfi	c a c f i	1
ichjd	i c h j d	1
cheef	c h e e f	1
bbai	b b a i	1
cbcei	c b c e i	1
hehchej	h e h c h e j	1
ejaedj	e j a e d j	1
egch	e g c h	1
dbfafh	d b f a f h	1
cgcbjf	c g c b j f	1
dbceh	d b c e h	1
cjcdi	c j c d i	1
jbdh	j b d h	1
dgf	d g f	1
djiaca	d j i a c a	1
igdfcfh	i g d f c f h	1
igc	i g c	1
ghjhjigi	g h j h j i g i	1
ehebc	e h e b c	1
abbgafda	a b b g a f d a	1
aea	a e a	1
ccbhh	c c b h h	1
ihiag	i h i a g	1
ifaaj	i f a a j	1
cfchg	c f c h g	1
fhfcaef	f h f c a e f	1
aifjh	a i f j h	1
dida	d i d a	1
eii	e i i	1
ibbfcbdc	i b b f c b d c	1
aeiad	a e i a d	1
bic	b i c	1
baggbd	b a g g b d	1
dhhfgaj	d h h f g a j	1
cbcg	c b c g	1
fbbaf	f b b a f	1
ecbhchc	e c b h c h c	1
dgfaegd	d g f a e g d	1
fecjijcf	f e c j i j c f	1
dbgagb	d b g a g b	1
ecicj	e c i c j	1
dj	d j	1
ggcc	g g c c	1
aij	a i j	1
ffedgc	f f e d g c	1
ihcg	i h c g	1
idfciije	i d f c i i j e	1
dbihe	d b i h e	1
ihfj	i h f j	1
jibfh	j i b f h	1
gighicg	g i g h i c g	1
ajbfab	a j b f a b	1
ghcchcf	g h c c h c f	1
bjii	b j i i	1
jbag	j b a g	1
iebci	i e b c i	1
ibbc	i b b c	1
jfccj	j f c c j	1
eghebe	e g h e b e	1
fdfcbfhj	f d f c b f h j	1
gfacdi	g f a c d i	1
ejifjf	e j i f j f	1
jgajbhfc	j g a j b h f c	1
fhcbcf	f h c b c f	1
jjijjah	j j i j j a h	1
fbg	f b g	1
adcec	a d c e c	1
babdhih	b a b d h i h	1
gfdhgghc	g f d h g g h c	1
cecdec	c e c d e c	1
ajbfejha	a j b f e j h a	1
gaghjbf	g a g h j b f	1
fcacgi	f c a c g i	1
dji	d j i	1
gfcci	g f c c i	1
diijfcf	d i i j f c f	1
ehbc	e h b c	1
fcieicib	f c i e i c i b	1
cdiggh	c d i g g h	1
gbhfcd	g b h f c d	1
ijee	i j e e	1
cfaicb	c f a i c b	1
giacc	g i a c c	1
begjgbfb	b e g j g b f b	1
fbcejca	f b c e j c a	1
cied	c i e d	1
heheffcb	h e h e f f c b	1
ghajc	g h a j c	1
fajj	f a j j	1
hifj	h i f j	1
cfc	c f c	1
gijdcc	g i j d c c	1
diejeief	d i e j e i e f	1
headhcdf	h e a d h c d f	1
fjhdec	f j h d e c	1
jccfh	j c c f h	1
cahg	c a h g	1
ieciac	i e c i a c	1
aiichhha	a i i c h h h a	1
jf	j f	1
daihjb	d a i h j b	1
ibiih	i b i i h	1
bjaf	b j a f	1
cedjeac	c e d j e a c	1
debda	d e b d a	1
dhidcc	d h i d c c	1
bbhia	b b h i a	1
cfadgaj	c f a d g a j	1
bcejii	b c e j i i	1
bigi	b i g i	1
gii	g i i	1
fcdcj	f c d c j	1
dhchdh	d h c h d h	1
adghh	a d g h h	1
bdgc	b d g c	1
afh	a f h	1
cibie	c i b i e	1
ghghbci	g h g h b c i	1
dfjgbh	d f j g b h	1
ibfia	i b f i a	1
hfjaeh	h f j a e h	1
ebdahhhc	e b d a h h h c	1
bjdf	b j d f	1
ideh	i d e h	1
jbhbbfg	j b h b b f g	1
dhcadgei	d h c a d g e i	1
dfgaghbi	d f g a g h b i	1
jbgch	j b g c h	1
cfabcij	c f a b c i j	1
cdce	c d c e	1
cgdjfbh	c g d j f b h	1
gfic	g f i c	1
jbjidja	j b j i d j a	1
adhdf	a d h d f	1
hiiahec	h i i a h e c	1
habcjd	h a b c j d	1
hfgib	h f g i b	1
bae	b a e	1
agid	a g i d	1
gfcgi	g f c g i	1
ai	a i	1
eeb	e e b	1
ajjb	a j j b	1
iji	i j i	1
ica	i c a	1
giehajd	g i e h a j d	1
eaffhef	e a f f h e f	1
gbbfj	g b b f j	1
ghhed	g h h e d	1
dcj	d c j	1
figff	f i g f f	1
dhea	d h e a	1
dadcag	d a d c a g	1
fceicjh	f c e i c j h	1
gcgcaeb	g c g c a e b	1
egei	e g e i	1
fdag	f d a g	1
jic	j i c	1
chfghii	c h f g h i i	1
jc	j c	1
gfjideb	g f j i d e b	1
ffiifh	f f i i f h	1
eecdb	e e c d b	1
aheciid	a h e c i i d	1
bdjjedhf	b d j j e d h f	1
gieh	g i e h	1
jgbc	j g b c	1
jbajicfb	j b a j i c f b	1
eej	e e j	1
afdjia	a f d j i a	1
hcbhhj	h c b h h j	1
ajdc	a j d c	1
ibedj	i b e d j	1
hei	h e i	1
gdjc	g d j c	1
aejjfjdh	a e j j f j d h	1
hcecc	h c e c c	1
gcccc	g c c c c	1
bjajeadc	b j a j e a d c	1
bfbg	b f b g	1
efaeii	e f a e i i	1
hgfg	h g f g	1
ehhi	e h h i	1
eaige	e a i g e	1
gjed	g j e d	1
caabijjc	c a a b i j j c	1
aggefdh	a g g e f d h	1
aadgf	a a d g f	1
feeiie	f e e i i e	1
ggccij	g g c c i j	1
dfbic	d f b i c	1
adfbcj	a d f b c j	1
ajgdi	a j g d i	1
dacgabe	d a c g a b e	1
eabacgd	e a b a c g d	1
cfgebf	c f g e b f	1
bfcbcie	b f c b c i e	1
hdi	h d i	1
efijcajj	e f i j c a j j	1
ghcaeh	g h c a e h	1
egd	e g d	1
fegiic	f e g i i c	1
bihfc	b i h f c	1
dbgi	d b g i	1
ihdj	i h d j	1
fhbbbc	f h b b b c	1
aaadcedj	a a a d c e d j	1
df	d f	1
iddd	i d d d	1
agece	a g e c e	1
eeebcgj	e e e b c g j	1
iif	i i f	1
cehech	c e h e c h	1
iaddhi	i a d d h i	1
djebd	d j e b d	1
dgbfcfhc	d g b f c f h c	1
cdfchbea	c d f c h b e a	1
ffbaefjf	f f b a e f j f	1
dfgdebih	d f g d e b i h	1
jiccjaed	j i c c j a e d	1
bee	b e e	1
jjjf	j j j f	1
cig	c i g	1
adcg	a d c g	1
bhgabce	b h g a b c e	1
dccjhai	d c c j h a i	1
eiag	e i a g	1
habc	h a b c	1
jfach	j f a c h	1
dgdad	d g d a d	1
dech	d e c h	1
ajgjc	a j g j c	1
cgchbc	c g c h b c	1
gdgffdef	g d g f f d e f	1
jdjicid	j d j i c i d	1
cheeibj	c h e e i b j	1
iefadaci	i e f a d a c i	1
edfabbe	e d f a b b e	1
ghfjaei	g h f j a e i	1
hbjij	h b j i j	1
aiabah	a i a b a h	1
gbaif	g b a i f	1
igajj	i g a j j	1
gaici	g a i c i	1
ihceb	i h c e b	1
hefhbh	h e f h b h	1
cjjica	c j j i c a	1
fdifibch	f d i f i b c h	1
bjdaj	b j d a j	1
eaejhjh	e a e j h j h	1
dhgbcji	d h g b c j i	1
cbfcd	c b f c d	1
ad	a d	1
difj	d i f j	1
efbghff	e f b g h f f	1
ibajc	i b a j c	1
cdhic	c d h i c	1
cbaagb	c b a a g b	1
acd	a c d	1
aiehce	a i e h c e	1
cjecjchh	c j e c j c h h	1
gdhgc	g d h g c	1
adhja	a d h j a	1
jehehdh	j e h e h d h	1
fhdajgd	f h d a j g d	1
abhf	a b h f	1
ijbeac	i j b e a c	1
eeaddib	e e a d d i b	1
jdhfgjg	j d h f g j g	1
fbf	f b f	1
agicj	a g i c j	1
eia	e i a	1
diggji	d i g g j i	1
ddij	d d i j	1
fhiab	f h i a b	1
cjfffij	c j f f f i j	1
fb	f b	1
cgb	c g b	1
deee	d e e e	1
gjbjfgd	g j b j f g d	1
bajcecch	b a j c e c c h	1
cdafei	c d a f e i	1
bacj	b a c j	1
aaciii	a a c i i i	1
cbbgghbg	c b b g g h b g	1
dfgac	d f g a c	1
habiic	h a b i i c	1
ggd	g g d	1
hgbbjci	h g b b j c i	1
egaj	e g a j	1
eehh	e e h h	1
chjd	c h j d	1
hjjc	h j j c	1
dbjc	d b j c	1
heh	h e h	1
hiahe	h i a h e	1
bcghc	b c g h c	1
gdfc	g d f c	1
fjicg	f j i c g	1
bhdh	b h d h	1
hcidhceh	h c i d h c e h	1
fhhgj	f h h g j	1
jdgfe	j d g f e	1
dhhjdiia	d h h j d i i a	1
bfachj	b f a c h j	1
fihhic	f i h h i c	1
fieddbcc	f i e d d b c c	1
idci	i d c i	1
dgc	d g c	1
iihdc	i i h d c	1
hbhdbff	h b h d b f f	1
acjjbba	a c j j b b a	1
gjgagi	g j g a g i	1
hgi	h g i	1
bdbbbejb	b d b b b e j b	1
dhhd	d h h d	1
haeeich	h a e e i c h	1
gejegbfg	g e j e g b f g	1
gggaai	g g g a a i	1
faai	f a a i	1
cahidhc	c a h i d h c	1
fhd	f h d	1
dfecfji	d f e c f j i	1
gffjcghc	g f f j c g h c	1
eaa	e a a	1
fcci	f c c i	1
ddfbd	d d f b d	1
jhfdcfh	j h f d c f h	1
fgffj	f g f f j	1
hac	h a c	1
fdjc	f d j c	1
gfehc	g f e h c	1
ahcci	a h c c i	1
agcfaha	a g c f a h a	1
dhggcia	d h g g c i a	1
ccce	c c c e	1
hcfhg	h c f h g	1
deacgjdj	d e a c g j d j	1
edb	e d b	1
cdcbh	c d c b h	1
jfh	j f h	1
acaj	a c a j	1
dhdbdf	d h d b d f	1
gghghhfh	g g h g h h f h	1
iejfgefb	i e j f g e f b	1
egc	e g c	1
aejfjjia	a e j f j j i a	1
ddcj	d d c j	1
ccbfchjj	c c b f c h j j	1
eaaejc	e a a e j c	1
cfahche	c f a h c h e	1
gg	g g	1
diaicei	d i a i c e i	1
ifd	i f d	1
ahhghh	a h h g h h	1
jfhegc	j f h e g c	1
iagdad	i a g d a d	1
dcgahc	d c g a h c	1
aibg	a i b g	1
ifjcc	i f j c c	1
bhif	b h i f	1
fieehji	f i e e h j i	1
gicia	g i c i a	1
hea	h e a	1
agc	a g c	1
ejfb	e j f b	1
ibhchif	i b h c h i f	1
jbic	j b i c	1
idbi	i d b i	1
ieb	i e b	1
dahgc	d a h g c	1
ceacjh	c e a c j h	1
dhei	d h e i	1
fjdfijae	f j d f i j a e	1
bjd	b j d	1
bfhchcia	b f h c h c i a	1
fbghb	f b g h b	1
didfiieh	d i d f i i e h	1
baeb	b a e b	1
dbcig	d b c i g	1
chfbaijj	c h f b a i j j	1
eahijj	e a h i j j	1
jhfb	j h f b	1
cgjiahdi	c g j i a h d i	1
jjbijd	j j b i j d	1
egdjbcd	e g d j b c d	1
cedga	c e d g a	1
edjgac	e d j g a c	1
fahhga	f a h h g a	1
fdf	f d f	1
jijcjcc	j i j c j c c	1
hgchdi	h g c h d i	1
dcii	d c i i	1
ghb	g h b	1
hhjfecg	h h j f e c g	1
effeihh	e f f e i h h	1
fibfhe	f i b f h e	1
jhijcf	j h i j c f	1
ghgfcaa	g h g f c a a	1
aec	a e c	1
iadiii	i a d i i i	1
iadb	i a d b	1
jffgaji	j f f g a j i	1
iccf	i c c f	1
dch	d c h	1
fajaf	f a j a f	1
beb	b e b	1
fhie	f h i e	1
ggf	g g f	1
cibaaea	c i b a a e a	1
djgh	d j g h	1
dhaajh	d h a a j h	1
ijjahiih	i j j a h i i h	1
ffbif	f f b i f	1
gdijghc	g d i j g h c	1
ibc	i b c	1
cdc	c d c	1
fbhi	f b h i	1
caace	c a a c e	1
ajceh	a j c e h	1
bhdb	b h d b	1
bha	b h a	1
agdfjjaa	a g d f j j a a	1
hcea	h c e a	1
icjh	i c j h	1
bhejjgg	b h e j j g g	1
chfc	c h f c	1
djijcaif	d j i j c a i f	1
ifhi	i f h i	1
hai	h a i	1
ibdeeabd	i b d e e a b d	1
bhgdajcj	b h g d a j c j	1
gfhee	g f h e e	1
dfcccd	d f c c c d	1
fbjbfh	f b j b f h	1
ddjgffa	d d j g f f a	1
eic	e i c	1
ejj	e j j	1
ejjheaab	e j j h e a a b	1
aiaahaa	a i a a h a a	1
cgadeheh	c g a d e h e h	1
iiabeci	i i a b e c i	1
ghcddi	g h c d d i	1
gbd	g b d	1
gjcded	g j c d e d	1
agbf	a g b f	1
fcaihced	f c a i h c e d	1
gab	g a b	1
aficcc	a f i c c c	1
jjf	j j f	1
bgdfcah	b g d f c a h	1
fhjdgdd	f h j d g d d	1
dggahja	d g g a h j a	1
