fae	f a e	789
ef	e f	292
ja	j a	239
dh	d h	223
hiaa	h i a a	213
hhh	h h h	201
hha	h h a	96
ge	g e	94
b	b	92
aia	a i a	76
cj	c j	76
icehf	i c e h f	66
ej	e j	53
bb	b b	46
aj	a j	46
jbhhj	j b h h j	36
adjfa	a d j f a	35
ghhahhh	g h h a h h h	35
jfhfib	j f h f i b	34
bci	b c i	34
fcefa	f c e f a	26
hecghc	h e c g h c	24
dddhj	d d d h j	23
deij	d e i j	22
gf	g f	22
fhhiif	f h h i i f	21
j	j	20
aja	a j a	19
hi	h i	18
hfeh	h f e h	18
ei	e i	18
ccfe	c c f e	18
ejfiaf	e j f i a f	17
bggfi	b g g f i	17
fdiaa	f d i a a	15
aaj	a a j	15
bfiad	b f i a d	14
cihh	c i h h	13
jhejje	j h e j j e	12
hh	h h	12
jgdf	j g d f	12
ccjjh	c c j j h	11
dci	d c i	11
fdabea	f d a b e a	11
ieje	i e j e	11
ihi	i h i	11
ie	i e	11
djjfe	d j j f e	11
gbh	g b h	11
iaai	i a a i	10
feci	f e c i	10
iffd	i f f d	10
ieca	i e c a	10
eea	e e a	10
fi	f i	10
ahfc	a h f c	10
hafd	h a f d	10
iid	i i d	10
gced	g c e d	9
ifc	i f c	9
aejf	a e j f	9
hdi	h d i	9
jjcbb	j j c b b	9
abf	a b f	9
biej	b i e j	9
bi	b i	9
cf	c f	9
jiihhj	j i i h h j	9
heec	h e e c	8
hjhe	h j h e	8
fbajcj	f b a j c j	8
fhcjh	f h c j h	8
dijaf	d i j a f	8
habaaig	h a b a a i g	8
eehe	e e h e	8
ceahj	c e a h j	8
jhdh	j h d h	8
cgh	c g h	8
aad	a a d	8
abaa	a b a a	8
jciac	j c i a c	8
fdafg	f d a f g	7
fdhae	f d h a e	7
ib	i b	7
ebie	e b i e	7
edgde	e d g d e	7
ad	a d	7
acg	a c g	7
age	a g e	7
ceg	c e g	7
fggi	f g g i	7
afef	a f e f	7
gcigah	g c i g a h	7
ehjgc	e h j g c	7
cdcjei	c d c j e i	7
dhbahh	d h b a h h	7
cii	c i i	6
gfbah	g f b a h	6
ejii	e j i i	6
af	a f	6
cefj	c e f j	6
dch	d c h	6
ggh	g g h	6
ahedef	a h e d e f	6
gh	g h	6
ighhdaf	i g h h d a f	6
bad	b a d	6
aag	a a g	6
dha	d h a	6
fbihd	f b i h d	6
jje	j j e	6
bgeec	b g e e c	6
jhfei	j h f e i	6
chehg	c h e h g	6
bfghadi	b f g h a d i	6
bgheeb	b g h e e b	6
jh	j h	6
iagidede	i a g i d e d e	5
hjadhh	h j a d h h	5
fejia	f e j i a	5
dcbbea	d c b b e a	5
ceih	c e i h	5
acf	a c f	5
jhcf	j h c f	5
dfjj	d f j j	5
agdi	a g d i	5
aie	a i e	5
hef	h e f	5
ccgahj	c c g a h j	5
hjee	h j e e	5
cfaag	c f a a g	5
cddd	c d d d	5
eieehe	e i e e h e	5
ciaa	c i a a	5
hdeda	h d e d a	5
bggf	b g g f	5
fdfd	f d f d	5
hhfeeda	h h f e e d a	4
jbdaffda	j b d a f f d a	4
gacd	g a c d	4
bceiedjb	b c e i e d j b	4
fajfa	f a j f a	4
ced	c e d	4
eg	e g	4
iag	i a g	4
aehhcd	a e h h c d	4
bhhhi	b h h h i	4
chggaibd	c h g g a i b d	4
ihhecj	i h h e c j	4
jfffh	j f f f h	4
bhd	b h d	4
hjj	h j j	4
aiaije	a i a i j e	4
gbd	g b d	4
dfhege	d f h e g e	4
gedcceh	g e d c c e h	4
hff	h f f	4
cgbgeh	c g b g e h	4
fej	f e j	4
cjeed	c j e e d	4
gfia	g f i a	4
fchi	f c h i	4
haeaicbd	h a e a i c b d	4
hfe	h f e	4
jdii	j d i i	4
agfhj	a g f h j	4
ffhf	f f h f	4
fjh	f j h	4
bfah	b f a h	4
jjfica	j j f i c a	4
fjgchi	f j g c h i	4
hch	h c h	4
egha	e g h a	4
jia	j i a	4
fffe	f f f e	4
fafh	f a f h	4
hja	h j a	4
edd	e d d	4
aaeg	a a e g	3
ggg	g g g	3
haiehg	h a i e h g	3
iech	i e c h	3
bga	b g a	3
higd	h i g d	3
if	i f	3
diaabhe	d i a a b h e	3
gie	g i e	3
iebgh	i e b g h	3
jfbba	j f b b a	3
jjb	j j b	3
fed	f e d	3
bghcae	b g h c a e	3
cbijdh	c b i j d h	3
gj	g j	3
aee	a e e	3
dech	d e c h	3
eji	e j i	3
icge	i c g e	3
fcgeh	f c g e h	3
afahfd	a f a h f d	3
bcjcf	b c j c f	3
ebc	e b c	3
iahbde	i a h b d e	3
cjjh	c j j h	3
dbaai	d b a a i	3
cachfe	c a c h f e	3
jhihfc	j h i h f c	3
ajdbh	a j d b h	3
dcabi	d c a b i	3
eah	e a h	3
ccbjfc	c c b j f c	3
dciecea	d c i e c e a	3
djead	d j e a d	3
jcac	j c a c	3
aieaee	a i e a e e	3
echf	e c h f	3
ehcihfj	e h c i h f j	3
dcdb	d c d b	3
hjfa	h j f a	3
eabga	e a b g a	3
fhgifgf	f h g i f g f	3
ggceh	g g c e h	3
ifih	i f i h	3
bgc	b g c	3
chi	c h i	3
dcfdiad	d c f d i a d	3
fad	f a d	3
geigh	g e i g h	3
eihgfhgg	e i h g f h g g	3
ede	e d e	3
dbeafde	d b e a f d e	3
jhhja	j h h j a	3
cga	c g a	3
adf	a d f	3
caaf	c a a f	3
ggj	g g j	3
bejbahi	b e j b a h i	3
fah	f a h	3
bgcih	b g c i h	3
ebfd	e b f d	3
ahc	a h c	3
adgj	a d g j	3
fhade	f h a d e	3
adhe	a d h e	3
ega	e g a	3
idd	i d d	3
ffi	f f i	3
hfgcc	h f g c c	3
hjai	h j a i	3
afjagc	a f j a g c	3
ifcjj	i f c j j	3
bbhja	b b h j a	2
fejfcafd	f e j f c a f d	2
aeachdf	a e a c h d f	2
bhbh	b h b h	2
gfij	g f i j	2
dddcahgb	d d d c a h g b	2
cha	c h a	2
ihb	i h b	2
fichf	f i c h f	2
hjaifeeh	h j a i f e e h	2
ghb	g h b	2
fehh	f e h h	2
gbf	g b f	2
hajh	h a j h	2
iecjg	i e c j g	2
hbjf	h b j f	2
ffcfh	f f c f h	2
fgifa	f g i f a	2
geeahi	g e e a h i	2
cgjf	c g j f	2
bhbcgia	b h b c g i a	2
eeeeh	e e e e h	2
bjaef	b j a e f	2
adiah	a d i a h	2
ccache	c c a c h e	2
gahbdbj	g a h b d b j	2
hgjaeca	h g j a e c a	2
bcgghiej	b c g g h i e j	2
jfb	j f b	2
hhhjji	h h h j j i	2
fgehcf	f g e h c f	2
chh	c h h	2
cajcgfh	c a j c g f h	2
hdej	h d e j	2
cjjcj	c j j c j	2
heifhf	h e i f h f	2
ahced	a h c e d	2
eeih	e e i h	2
edj	e d j	2
gibhh	g i b h h	2
bbcgg	b b c g g	2
hebfdhg	h e b f d h g	2
gdehec	g d e h e c	2
bbhjeh	b b h j e h	2
aedihej	a e d i h e j	2
cifea	c i f e a	2
jgahi	j g a h i	2
gchhcai	g c h h c a i	2
hjhj	h j h j	2
hajcdgh	h a j c d g h	2
jige	j i g e	2
fbh	f b h	2
hfbbdad	h f b b d a d	2
iejjh	i e j j h	2
ggdbdfi	g g d b d f i	2
jhihbic	j h i h b i c	2
ecjg	e c j g	2
iec	i e c	2
ihghi	i h g h i	2
dgddb	d g d d b	2
fgbbe	f g b b e	2
cfjghch	c f j g h c h	2
fg	f g	2
eadj	e a d j	2
fe	f e	2
iabaehj	i a b a e h j	2
hgecddhd	h g e c d d h d	2
ceca	c e c a	2
fgfgai	f g f g a i	2
ach	a c h	2
dgj	d g j	2
hcc	h c c	2
ifie	i f i e	2
cheij	c h e i j	2
ebg	e b g	2
hfaad	h f a a d	2
gijhdgjb	g i j h d g j b	2
fjefce	f j e f c e	2
abiih	a b i i h	2
jfd	j f d	2
jefdffh	j e f d f f h	2
egifc	e g i f c	2
bb	b b	2
jefh	j e f h	2
gcaach	g c a a c h	2
fehebgjj	f e h e b g j j	2
ghdfcd	g h d f c d	2
gcbaha	g c b a h a	2
iijdaj	i i j d a j	2
jhb	j h b	2
hfdehf	h f d e h f	2
hbi	h b i	2
fhhahij	f h h a h i j	2
hhjfef	h h j f e f	2
hhabidec	h h a b i d e c	2
bdhe	b d h e	2
ifje	i f j e	2
ceehgda	c e e h g d a	2
iiefc	i i e f c	2
gcd	g c d	2
def	d e f	2
cijahh	c i j a h h	2
ibj	i b j	2
fcadaa	f c a d a a	2
aha	a h a	2
ddejgghi	d d e j g g h i	2
jhe	j h e	2
fcbaeeg	f c b a e e g	2
chead	c h e a d	2
ddhif	d d h i f	2
ggahi	g g a h i	2
eabihb	e a b i h b	2
bgj	b g j	2
fhbj	f h b j	2
jehhhha	j e h h h h a	2
gdg	g d g	2
hjiej	h j i e j	2
jefiefie	j e f i e f i e	2
ahg	a h g	2
afgacf	a f g a c f	2
eiih	e i i h	2
ejeee	e j e e e	2
bhghidgd	b h g h i d g d	2
dhhd	d h h d	2
aaghe	a a g h e	2
jcj	j c j	2
dgbdidh	d g b d i d h	2
fff	f f f	2
ffchahid	f f c h a h i d	2
cgadi	c g a d i	2
iadija	i a d i j a	2
cfgijeg	c f g i j e g	2
ieehcb	i e e h c b	2
hfghe	h f g h e	2
fdhbhff	f d h b h f f	2
cfi	c f i	2
badaba	b a d a b a	1
ffdba	f f d b a	1
cfic	c f i c	1
cbihgije	c b i h g i j e	1
jjehccac	j j e h c c a c	1
djaja	d j a j a	1
facjbcfi	f a c j b c f i	1
dfeiieg	d f e i i e g	1
jbdg	j b d g	1
gjcghhii	g j c g h h i i	1
facchfhe	f a c c h f h e	1
fhhijea	f h h i j e a	1
jef	j e f	1
acfe	a c f e	1
didheiij	d i d h e i i j	1
hehdieij	h e h d i e i j	1
biehcfdd	b i e h c f d d	1
giagf	g i a g f	1
cggdadf	c g g d a d f	1
hjfdi	h j f d i	1
debch	d e b c h	1
egaici	e g a i c i	1
aeb	a e b	1
hijihd	h i j i h d	1
acchehi	a c c h e h i	1
fjihcge	f j i h c g e	1
hc	h c	1
ffjb	f f j b	1
aahdg	a a h d g	1
fhdhb	f h d h b	1
cbjh	c b j h	1
bcaggde	b c a g g d e	1
deeca	d e e c a	1
jiajge	j i a j g e	1
hebf	h e b f	1
icifiac	i c i f i a c	1
egbfi	e g b f i	1
fadh	f a d h	1
addfi	a d d f i	1
dacibf	d a c i b f	1
feda	f e d a	1
ddbadidj	d d b a d i d j	1
gdagag	g d a g a g	1
diahh	d i a h h	1
gha	g h a	1
giegjdg	g i e g j d g	1
fcb	f c b	1
deab	d e a b	1
iccia	i c c i a	1
ghidcgj	g h i d c g j	1
jadhdaj	j a d h d a j	1
dgaa	d g a a	1
dgcajdg	d g c a j d g	1
jgfjjhjd	j g f j j h j d	1
cjg	c j g	1
ggfbd	g g f b d	1
cebf	c e b f	1
gjeeega	g j e e e g a	1
gaebcd	g a e b c d	1
dcehcdia	d c e h c d i a	1
gjah	g j a h	1
ebhhe	e b h h e	1
egj	e g j	1
hfeb	h f e b	1
jedbh	j e d b h	1
jcheeb	j c h e e b	1
eci	e c i	1
aeddhe	a e d d h e	1
ccfij	c c f i j	1
jhbh	j h b h	1
cchii	c c h i i	1
fjgaif	f j g a i f	1
gbbbe	g b b b e	1
dhiicic	d h i i c i c	1
dejdeaid	d e j d e a i d	1
ddehe	d d e h e	1
giee	g i e e	1
icc	i c c	1
ghj	g h j	1
bbeb	b b e b	1
gdffje	g d f f j e	1
chcaafca	c h c a a f c a	1
giii	g i i i	1
dbd	d b d	1
cchi	c c h i	1
ahbjh	a h b j h	1
hcbhh	h c b h h	1
edfdgii	e d f d g i i	1
fda	f d a	1
hffeb	h f f e b	1
jaebf	j a e b f	1
da	d a	1
faa	f a a	1
gdgcifd	g d g c i f d	1
fc	f c	1
ggdbih	g g d b i h	1
aeehfhj	a e e h f h j	1
hcbg	h c b g	1
hhe	h h e	1
dhddhfi	d h d d h f i	1
ddggiggf	d d g g i g g f	1
ghgfja	g h g f j a	1
eibdjiji	e i b d j i j i	1
aicfjj	a i c f j j	1
jihc	j i h c	1
eajh	e a j h	1
jci	j c i	1
ebjic	e b j i c	1
afcedjh	a f c e d j h	1
gfjdfgb	g f j d f g b	1
abde	a b d e	1
hhegf	h h e g f	1
fcfae	f c f a e	1
dcch	d c c h	1
cidi	c i d i	1
haaa	h a a a	1
ffafchc	f f a f c h c	1
jebij	j e b i j	1
deif	d e i f	1
fcga	f c g a	1
addfcaa	a d d f c a a	1
feb	f e b	1
ffbgaib	f f b g a i b	1
fdid	f d i d	1
aicfjdf	a i c f j d f	1
hacg	h a c g	1
bdih	b d i h	1
dia	d i a	1
ihgf	i h g f	1
beehc	b e e h c	1
gfiiicb	g f i i i c b	1
ccfhhe	c c f h h e	1
cdbicgai	c d b i c g a i	1
ibcadhd	i b c a d h d	1
iabjjihi	i a b j j i h i	1
jddh	j d d h	1
ebeej	e b e e j	1
ijddfdf	i j d d f d f	1
afbb	a f b b	1
ddhha	d d h h a	1
ebgi	e b g i	1
agcbj	a g c b j	1
abbeid	a b b e i d	1
ead	e a d	1
adefha	a d e f h a	1
eii	e i i	1
jahfa	j a h f a	1
ebe	e b e	1
hghbbieb	h g h b b i e b	1
jgejhfia	j g e j h f i a	1
dhaai	d h a a i	1
dcdd	d c d d	1
achd	a c h d	1
bgeddae	b g e d d a e	1
ajbf	a j b f	1
jiifiga	j i i f i g a	1
iedbga	i e d b g a	1
jbebc	j b e b c	1
edifajac	e d i f a j a c	1
bdhchiig	b d h c h i i g	1
jdi	j d i	1
fifeegj	f i f e e g j	1
haiah	h a i a h	1
hafif	h a f i f	1
bedha	b e d h a	1
jbaah	j b a a h	1
ecgdd	e c g d d	1
chejihf	c h e j i h f	1
bjhdah	b j h d a h	1
ajedj	a j e d j	1
hcfbcb	h c f b c b	1
aebij	a e b i j	1
jidihei	j i d i h e i	1
fjjfhh	f j j f h h	1
hhfhe	h h f h e	1
cefb	c e f b	1
cecei	c e c e i	1
fegaa	f e g a a	1
bdiecc	b d i e c c	1
daijhfc	d a i j h f c	1
acaebfb	a c a e b f b	1
gbiajce	g b i a j c e	1
cajh	c a j h	1
bgdhj	b g d h j	1
jeab	j e a b	1
cgdf	c g d f	1
ddhdd	d d h d d	1
heaigg	h e a i g g	1
iha	i h a	1
ebceaeha	e b c e a e h a	1
hdab	h d a b	1
ahca	a h c a	1
jcfjc	j c f j c	1
igdcbba	i g d c b b a	1
idaghdd	i d a g h d d	1
hjeeh	h j e e h	1
ihe	i h e	1
chbcbjb	c h b c b j b	1
ddib	d d i b	1
jidihdj	j i d i h d j	1
jagj	j a g j	1
fcbg	f c b g	1
idejjeh	i d e j j e h	1
aiad	a i a d	1
fddfhffj	f d d f h f f j	1
cfibeafg	c f i b e a f g	1
fhdjgdg	f h d j g d g	1
ebbh	e b b h	1
iccaha	i c c a h a	1
iejdifij	i e j d i f i j	1
bgjffi	b g j f f i	1
ebggd	e b g g d	1
dgceddc	d g c e d d c	1
hjdhdj	h j d h d j	1
abjccfe	a b j c c f e	1
dceijiei	d c e i j i e i	1
gdifc	g d i f c	1
adhfbi	a d h f b i	1
eece	e e c e	1
fajhdch	f a j h d c h	1
difjfjh	d i f j f j h	1
jjgfejc	j j g f e j c	1
gfahhe	g f a h h e	1
gde	g d e	1
ajhhf	a j h h f	1
bhhcce	b h h c c e	1
jcg	j c g	1
bicg	b i c g	1
fge	f g e	1
ejj	e j j	1
fcfej	f c f e j	1
hbjhfbeb	h b j h f b e b	1
ifii	i f i i	1
jaabhci	j a a b h c i	1
gghab	g g h a b	1
cdcg	c d c g	1
gdcdge	g d c d g e	1
heeichcc	h e e i c h c c	1
abheh	a b h e h	1
gfbgghdh	g f b g g h d h	1
bji	b j i	1
fjeebjc	f j e e b j c	1
cgjbjf	c g j b j f	1
fdebehe	f d e b e h e	1
jcc	j c c	1
iefja	i e f j a	1
jcbfigc	j c b f i g c	1
hcaai	h c a a i	1
fabdch	f a b d c h	1
iifh	i i f h	1
habgabc	h a b g a b c	1
ffdafj	f f d a f j	1
jfaha	j f a h a	1
bh	b h	1
hdh	h d h	1
jbabfhe	j b a b f h e	1
hjcb	h j c b	1
iib	i i b	1
chd	c h d	1
dhcha	d h c h a	1
jhhcdh	j h h c d h	1
cagd	c a g d	1
ebeh	e b e h	1
iehgidia	i e h g i d i a	1
jdha	j d h a	1
bgfbdiha	b g f b d i h a	1
gajfaebh	g a j f a e b h	1
hfedgcc	h f e d g c c	1
aeafg	a e a f g	1
bifg	b i f g	1
ebcbbeac	e b c b b e a c	1
baahdai	b a a h d a i	1
fddaa	f d d a a	1
fggd	f g g d	1
ejaejhe	e j a e j h e	1
cifffij	c i f f f i j	1
ebfah	e b f a h	1
biacg	b i a c g	1
hceebh	h c e e b h	1
gjefia	g j e f i a	1
ccafh	c c a f h	1
ddeg	d d e g	1
aeddid	a e d d i d	1
higcdj	h i g c d j	1
fccefj	f c c e f j	1
jde	j d e	1
cfgiidh	c f g i i d h	1
gcad	g c a d	1
aaa	a a a	1
gajbgic	g a j b g i c	1
jjbcchfc	j j b c c h f c	1
begcjh	b e g c j h	1
ceeh	c e e h	1
gbjah	g b j a h	1
cebheh	c e b h e h	1
idfifidb	i d f i f i d b	1
ejjiddhd	e j j i d d h d	1
gdecea	g d e c e a	1
cc	c c	1
cibaef	c i b a e f	1
ejcjh	e j c j h	1
gbhea	g b h e a	1
eheehg	e h e e h g	1
ifijcfbe	i f i j c f b e	1
djee	d j e e	1
efjddi	e f j d d i	1
habhjj	h a b h j j	1
jjcigc	j j c i g c	1
dafcf	d a f c f	1
cfe	c f e	1
aiddf	a i d d f	1
gca	g c a	1
hdihbji	h d i h b j i	1
eeae	e e a e	1
jihcbhja	j i h c b h j a	1
ejbfhgd	e j b f h g d	1
hhf	h h f	1
fjjeh	f j j e h	1
jaj	j a j	1
gahhh	g a h h h	1
eijc	e i j c	1
biadd	b i a d d	1
ihee	i h e e	1
hcdj	h c d j	1
ggcjdej	g g c j d e j	1
aajcfcai	a a j c f c a i	1
efdihd	e f d i h d	1
dabi	d a b i	1
bih	b i h	1
ijech	i j e c h	1
efigbifh	e f i g b i f h	1
cciagh	c c i a g h	1
gede	g e d e	1
jjicbc	j j i c b c	1
hcafg	h c a f g	1
hcadf	h c a d f	1
ihbgga	i h b g g a	1
fgjeigf	f g j e i g f	1
ddcegcig	d d c e g c i g	1
higggah	h i g g g a h	1
gcdd	g c d d	1
ehgfdgea	e h g f d g e a	1
ce	c e	1
idacj	i d a c j	1
ddcfh	d d c f h	1
cihha	c i h h a	1
ibbffhh	i b b f f h h	1
ifhjhi	i f h j h i	1
eacfae	e a c f a e	1
chfgj	c h f g j	1
hffebc	h f f e b c	1
jbbc	j b b c	1
dhjffje	d h j f f j e	1
hcedahgb	h c e d a h g b	1
gba	g b a	1
aba	a b a	1
agfd	a g f d	1
dhjih	d h j i h	1
ddehh	d d e h h	1
hfdfde	h f d f d e	1
jha	j h a	1
dee	d e e	1
ddebcd	d d e b c d	1
gjjcch	g j j c c h	1
igfa	i g f a	1
ecihjg	e c i h j g	1
jghe	j g h e	1
fchfa	f c h f a	1
cacgdhhh	c a c g d h h h	1
bjjj	b j j j	1
fieidcdd	f i e i d c d d	1
eciihhci	e c i i h h c i	1
hacbjf	h a c b j f	1
hjbhee	h j b h e e	1
ddjbbdbd	d d j b b d b d	1
ccgef	c c g e f	1
gehjcfcf	g e h j c f c f	1
ebbf	e b b f	1
fcch	f c c h	1
ccfbh	c c f b h	1
aicfgc	a i c f g c	1
jfdahjh	j f d a h j h	1
bgige	b g i g e	1
cijhaa	c i j h a a	1
iidhaf	i i d h a f	1
fejh	f e j h	1
efgha	e f g h a	1
hege	h e g e	1
hiaaeihd	h i a a e i h d	1
djgc	d j g c	1
icbidi	i c b i d i	1
hgcfd	h g c f d	1
gccfbifd	g c c f b i f d	1
ebcfggb	e b c f g g b	1
dcihhe	d c i h h e	1
cbeebf	c b e e b f	1
cihhbeba	c i h h b e b a	1
cif	c i f	1
gbeh	g b e h	1
gabf	g a b f	1
hachghc	h a c h g h c	1
bjiif	b j i i f	1
daebg	d a e b g	1
fjcj	f j c j	1
gbg	g b g	1
eafhiac	e a f h i a c	1
ibbice	i b b i c e	1
ijeaee	i j e a e e	1
hcaad	h c a a d	1
abfcae	a b f c a e	1
idhea	i d h e a	1
gcecaae	g c e c a a e	1
gcei	g c e i	1
jec	j e c	1
cfghi	c f g h i	1
hedjg	h e d j g	1
cefaa	c e f a a	1
bageeh	b a g e e h	1
adea	a d e a	1
dcacehic	d c a c e h i c	1
idbjb	i d b j b	1
aacfcd	a a c f c d	1
jcehi	j c e h i	1
jbi	j b i	1
ihihe	i h i h e	1
gided	g i d e d	1
cac	c a c	1
adcjf	a d c j f	1
jcbeh	j c b e h	1
hcfei	h c f e i	1
begedei	b e g e d e i	1
gagh	g a g h	1
adjed	a d j e d	1
agicfh	a g i c f h	1
hbfdi	h b f d i	1
beg	b e g	1
ghcgd	g h c g d	1
ijgbgh	i j g b g h	1
hcbaeed	h c b a e e d	1
jed	j e d	1
gcaihgh	g c a i h g h	1
jjih	j j i h	1
ghiidc	g h i i d c	1
ccagiji	c c a g i j i	1
adeg	a d e g	1
fgfdcbb	f g f d c b b	1
dbjfiaeb	d b j f i a e b	1
didcbjfh	d i d c b j f h	1
hj	h j	1
eehfj	e e h f j	1
hiedj	h i e d j	1
hhbcbgjj	h h b c b g j j	1
jgeaaah	j g e a a a h	1
giabfgea	g i a b f g e a	1
jjafe	j j a f e	1
biefdc	b i e f d c	1
ddfde	d d f d e	1
ddbhhg	d d b h h g	1
idah	i d a h	1
ffcf	f f c f	1
ebggf	e b g g f	1
jb	j b	1
bhcecja	b h c e c j a	1
beea	b e e a	1
ejfch	e j f c h	1
hjeh	h j e h	1
hhg	h h g	1
bcaiiic	b c a i i i c	1
hedh	h e d h	1
eeagfdid	e e a g f d i d	1
ijfeeea	i j f e e e a	1
hjgbhbjj	h j g b h b j j	1
egf	e g f	1
jejjc	j e j j c	1
faecffhc	f a e c f f h c	1
bffh	b f f h	1
fhjfi	f h j f i	1
gad	g a d	1
bichae	b i c h a e	1
egeg	e g e g	1
eceha	e c e h a	1
dfbdief	d f b d i e f	1
jdfi	j d f i	1
eaadhh	e a a d h h	1
adehbh	a d e h b h	1
ccggg	c c g g g	1
dggeb	d g g e b	1
fdiicjba	f d i i c j b a	1
bdaeeehg	b d a e e e h g	1
cjja	c j j a	1
jhcgead	j h c g e a d	1
chahh	c h a h h	1
cebe	c e b e	1
aicij	a i c i j	1
ghjih	g h j i h	1
jgfb	j g f b	1
jcejj	j c e j j	1
fcaa	f c a a	1
gbfa	g b f a	1
eiijhdf	e i i j h d f	1
cceeegc	c c e e e g c	1
bjjd	b j j d	1
eahgadd	e a h g a d d	1
jgde	j g d e	1
edfci	e d f c i	1
geegg	g e e g g	1
hjhgf	h j h g f	1
dhcafg	d h c a f g	1
bhfae	b h f a e	1
cebij	c e b i j	1
caigfa	c a i g f a	1
hhjbhcj	h h j b h c j	1
gi	g i	1
eajdeb	e a j d e b	1
gfh	g f h	1
ijfgij	i j f g i j	1
ahhcgjbd	a h h c g j b d	1
chj	c h j	1
hjjdaice	h j j d a i c e	1
jihbajg	j i h b a j g	1
idefea	i d e f e a	1
fechi	f e c h i	1
icccgc	i c c c g c	1
ajchjj	a j c h j j	1
hjfabc	h j f a b c	1
jfheih	j f h e i h	1
gfchbe	g f c h b e	1
gbbiha	g b b i h a	1
dbg	d b g	1
cdedii	c d e d i i	1
biaiaj	b i a i a j	1
hgac	h g a c	1
geehf	g e e h f	1
bidjhid	b i d j h i d	1
ghh	g h h	1
jgia	j g i a	1
fdiicdaf	f d i i c d a f	1
cdcfj	c d c f j	1
bcahh	b c a h h	1
aaia	a a i a	1
faaaa	f a a a a	1
ejbh	e j b h	1
fch	f c h	1
ecea	e c e a	1
hcha	h c h a	1
dhgeba	d h g e b a	1
bihfh	b i h f h	1
dic	d i c	1
dgi	d g i	1
becddh	b e c d d h	1
jefbg	j e f b g	1
gchaacch	g c h a a c c h	1
jbaegfd	j b a e g f d	1
dcjhada	d c j h a d a	1
egfbedec	e g f b e d e c	1
jjge	j j g e	1
hihhi	h i h h i	1
ebdh	e b d h	1
cghi	c g h i	1
gbgd	g b g d	1
ecadc	e c a d c	1
fgi	f g i	1
jgdgdbb	j g d g d b b	1
jjbbcjjc	j j b b c j j c	1
dfdhgg	d f d h g g	1
iaebcce	i a e b c c e	1
dehaijc	d e h a i j c	1
ebhfd	e b h f d	1
cai	c a i	1
dcc	d c c	1
hhgfi	h h g f i	1
haea	h a e a	1
ffje	f f j e	1
dgiagifc	d g i a g i f c	1
ecfddc	e c f d d c	1
bbcig	b b c i g	1
cdhe	c d h e	1
gidh	g i d h	1
cccfb	c c c f b	1
ahifh	a h i f h	1
bdgj	b d g j	1
cefdghc	c e f d g h c	1
ieac	i e a c	1
agjebbfh	a g j e b b f h	1
cgifag	c g i f a g	1
debd	d e b d	1
adfgabi	a d f g a b i	1
ijdhe	i j d h e	1
dbdaabi	d b d a a b i	1
hbeifhi	h b e i f h i	1
dbdbaeba	d b d b a e b a	1
cid	c i d	1
jigaced	j i g a c e d	1
acii	a c i i	1
aijabgg	a i j a b g g	1
jihd	j i h d	1
jihe	j i h e	1
cdbbgd	c d b b g d	1
gjedgag	g j e d g a g	1
jafj	j a f j	1
eehdhfj	e e h d h f j	1
jbc	j b c	1
hjcii	h j c i i	1
cfcj	c f c j	1
hhcih	h h c i h	1
eehcd	e e h c d	1
eccfb	e c c f b	1
ejf	e j f	1
behgiehi	b e h g i e h i	1
hjih	h j i h	1
aiejef	a i e j e f	1
ibejb	i b e j b	1
bhhff	b h h f f	1
