echdehi	e c h d e h i	1791
ehcbjac	e h c b j a c	1275
cfjcc	c f j c c	780
bejfdec	b e j f d e c	254
efaa	e f a a	220
efjdcfih	e f j d c f i h	189
jefeg	j e f e g	183
cgdjei	c g d j e i	75
hgd	h g d	71
fbh	f b h	68
bbgadd	b b g a d d	67
ajea	a j e a	56
dajciiab	d a j c i i a b	55
ihdh	i h d h	55
cica	c i c a	53
efeh	e f e h	37
dah	d a h	35
aiabac	a i a b a c	35
ibdd	i b d d	33
iac	i a c	28
idgfgic	i d g f g i c	26
edjfaeic	e d j f a e i c	25
iaeghc	i a e g h c	25
gcbgdfgf	g c b g d f g f	25
fbb	f b b	25
gbefag	g b e f a g	24
iijcf	i i j c f	23
ghjag	g h j a g	23
fah	f a h	22
hchjdcc	h c h j d c c	22
hbaaa	h b a a a	22
jfffbgd	j f f f b g d	22
cgbe	c g b e	22
fjdhe	f j d h e	21
agfdb	a g f d b	20
ecadgj	e c a d g j	20
bca	b c a	19
ibejhbif	i b e j h b i f	19
cghfge	c g h f g e	19
geej	g e e j	18
acgeec	a c g e e c	17
ifhie	i f h i e	17
cdaijf	c d a i j f	17
eecbe	e e c b e	17
fihbhcgh	f i h b h c g h	16
cbddd	c b d d d	16
edcja	e d c j a	15
cjagea	c j a g e a	15
jcihjjfb	j c i h j j f b	15
ghbdgbbg	g h b d g b b g	15
jjdacbd	j j d a c b d	15
djdfi	d j d f i	14
ehhdhgce	e h h d h g c e	14
gigjhijj	g i g j h i j j	14
cgi	c g i	14
edfhbd	e d f h b d	13
abfgidjh	a b f g i d j h	13
jief	j i e f	13
gijaja	g i j a j a	13
cffibhei	c f f i b h e i	12
dfb	d f b	12
dcdgb	d c d g b	12
bifhih	b i f h i h	11
ggbadg	g g b a d g	11
bfe	b f e	11
abifecb	a b i f e c b	11
hacdad	h a c d a d	11
highcade	h i g h c a d e	11
idddg	i d d d g	10
hfdbaj	h f d b a j	10
efjdg	e f j d g	10
eahdjhb	e a h d j h b	10
egfdh	e g f d h	10
eaeh	e a e h	9
djcbaj	d j c b a j	9
fcac	f c a c	9
adabdjh	a d a b d j h	9
jebfjcb	j e b f j c b	9
fddgb	f d d g b	9
cbc	c b c	8
jcdjffji	j c d j f f j i	8
fei	f e i	8
jibjbjc	j i b j b j c	8
ihgacig	i h g a c i g	8
chjhfd	c h j h f d	8
jeg	j e g	8
aihh	a i h h	7
hca	h c a	7
bhd	b h d	7
fif	f i f	7
eagdf	e a g d f	7
cai	c a i	7
idgigjjd	i d g i g j j d	7
gaaagaci	g a a a g a c i	7
djje	d j j e	7
gbja	g b j a	7
gfjfc	g f j f c	6
feb	f e b	6
fhggehg	f h g g e h g	6
gjf	g j f	6
fcfhfige	f c f h f i g e	6
jeieb	j e i e b	6
hbghfigc	h b g h f i g c	6
hbacie	h b a c i e	6
jhcjgfb	j h c j g f b	6
jjj	j j j	6
efd	e f d	6
achfdef	a c h f d e f	6
cddbag	c d d b a g	6
febjcjea	f e b j c j e a	5
daiic	d a i i c	5
bbgi	b b g i	5
fjca	f j c a	5
adeggegc	a d e g g e g c	5
dfhedb	d f h e d b	5
babhe	b a b h e	5
bhjaifib	b h j a i f i b	5
jajeib	j a j e i b	5
jgej	j g e j	5
adfegh	a d f e g h	5
fjhj	f j h j	5
ahb	a h b	5
bgeibea	b g e i b e a	5
dbii	d b i i	5
abi	a b i	5
biidfaeg	b i i d f a e g	5
iebh	i e b h	5
aeejdj	a e e j d j	5
cjc	c j c	4
beiadg	b e i a d g	4
gcdjjb	g c d j j b	4
hbeacdgf	h b e a c d g f	4
bcbbaadc	b c b b a a d c	4
bjf	b j f	4
hahdfch	h a h d f c h	4
bihij	b i h i j	4
iiea	i i e a	4
ijbc	i j b c	4
fghj	f g h j	4
jiijiifa	j i i j i i f a	4
jgfh	j g f h	4
gbjid	g b j i d	4
bef	b e f	4
dhhbh	d h h b h	4
gaa	g a a	4
iidd	i i d d	4
hejgfcb	h e j g f c b	4
jhfijfje	j h f i j f j e	4
gbh	g b h	4
gihbif	g i h b i f	4
fcghda	f c g h d a	4
dhcf	d h c f	4
iacjbg	i a c j b g	4
gfbjjb	g f b j j b	4
baef	b a e f	4
gjjj	g j j j	4
icgdheie	i c g d h e i e	4
ejc	e j c	4
hied	h i e d	4
dbedcg	d b e d c g	4
idaghh	i d a g h h	4
fibjhd	f i b j h d	4
hcdebig	h c d e b i g	4
addgchee	a d d g c h e e	4
addbbjfg	a d d b b j f g	3
ibbceaa	i b b c e a a	3
fbaigb	f b a i g b	3
ccga	c c g a	3
ihjjj	i h j j j	3
bjbg	b j b g	3
jafffe	j a f f f e	3
ggi	g g i	3
bjfgidh	b j f g i d h	3
igafe	i g a f e	3
gbhdd	g b h d d	3
geb	g e b	3
bacgajea	b a c g a j e a	3
jcabdif	j c a b d i f	3
hbgc	h b g c	3
eeacfedb	e e a c f e d b	3
bggf	b g g f	3
idibii	i d i b i i	3
ddch	d d c h	3
hibbed	h i b b e d	3
ehfg	e h f g	3
ahh	a h h	3
gfbij	g f b i j	3
cecjci	c e c j c i	3
fdhjhaag	f d h j h a a g	3
ajb	a j b	3
icddbh	i c d d b h	3
hjb	h j b	3
ajda	a j d a	3
bgcigjd	b g c i g j d	3
ebfci	e b f c i	3
iehbhah	i e h b h a h	3
ichi	i c h i	3
gdf	g d f	3
facggif	f a c g g i f	3
jgfhjcgi	j g f h j c g i	3
hagcbib	h a g c b i b	3
jfccii	j f c c i i	3
dbfefag	d b f e f a g	3
hbji	h b j i	3
hgeaiije	h g e a i i j e	3
didjfc	d i d j f c	3
gdb	g d b	3
edjgfbbd	e d j g f b b d	3
adfgab	a d f g a b	3
efjfjiad	e f j f j i a d	2
ebbc	e b b c	2
iajjcgg	i a j j c g g	2
hbajbdjb	h b a j b d j b	2
igifjj	i g i f j j	2
figibd	f i g i b d	2
jdeecic	j d e e c i c	2
haebe	h a e b e	2
bdggh	b d g g h	2
gifaa	g i f a a	2
fha	f h a	2
ifcdehed	i f c d e h e d	2
cfegeg	c f e g e g	2
hac	h a c	2
dag	d a g	2
dbfjbg	d b f j b g	2
bhhcef	b h h c e f	2
jhadffh	j h a d f f h	2
jjcedf	j j c e d f	2
eejcfa	e e j c f a	2
igda	i g d a	2
bbidi	b b i d i	2
ejjejf	e j j e j f	2
ade	a d e	2
jhcdbc	j h c d b c	2
eagaded	e a g a d e d	2
cccgffb	c c c g f f b	2
gigagefe	g i g a g e f e	2
bfgeg	b f g e g	2
ggedfjg	g g e d f j g	2
cjf	c j f	2
ihgfece	i h g f e c e	2
cdaigecg	c d a i g e c g	2
bacgegb	b a c g e g b	2
hicfb	h i c f b	2
eahb	e a h b	2
biijeh	b i i j e h	2
jfadd	j f a d d	2
iecdhfj	i e c d h f j	2
hjh	h j h	2
gjaedbga	g j a e d b g a	2
djj	d j j	2
efgcci	e f g c c i	2
ibjgiba	i b j g i b a	2
dechgig	d e c h g i g	2
idj	i d j	2
iiaffhe	i i a f f h e	2
fijghiab	f i j g h i a b	2
fdifciei	f d i f c i e i	2
ciaeeg	c i a e e g	2
dajjgjc	d a j j g j c	2
daib	d a i b	2
efaabgih	e f a a b g i h	2
hgfdjfi	h g f d j f i	2
cggh	c g g h	2
ejjf	e j j f	2
cbegjejj	c b e g j e j j	2
cbgcjee	c b g c j e e	2
agi	a g i	2
ieahc	i e a h c	2
bdac	b d a c	2
ejfc	e j f c	2
hdfdj	h d f d j	2
bfcihf	b f c i h f	2
bdhgghd	b d h g g h d	2
jgd	j g d	2
ejceaeg	e j c e a e g	2
affae	a f f a e	2
hadhf	h a d h f	2
fecbj	f e c b j	2
dcccj	d c c c j	2
jghijf	j g h i j f	2
fdij	f d i j	2
fgefijac	f g e f i j a c	2
bbj	b b j	2
fcf	f c f	2
iad	i a d	2
jaheijdc	j a h e i j d c	2
gcc	g c c	2
bghfgfhb	b g h f g f h b	2
djffgf	d j f f g f	2
hcdi	h c d i	2
dgii	d g i i	2
ide	i d e	2
ehdi	e h d i	2
cdfdje	c d f d j e	2
gedgcihg	g e d g c i h g	2
bdba	b d b a	2
acb	a c b	2
jciecj	j c i e c j	2
ecd	e c d	2
fdd	f d d	2
baafif	b a a f i f	2
gggj	g g g j	2
cbccf	c b c c f	2
ddbcahcg	d d b c a h c g	2
dhi	d h i	2
ibcdgi	i b c d g i	2
gaaddadh	g a a d d a d h	2
icdhc	i c d h c	2
ejdiiid	e j d i i i d	2
hbfjc	h b f j c	2
jcajh	j c a j h	2
fejca	f e j c a	2
hcihb	h c i h b	2
hbh	h b h	2
chdj	c h d j	2
decgfhf	d e c g f h f	2
ehd	e h d	2
aiff	a i f f	2
dgjci	d g j c i	2
fcjbb	f c j b b	2
gjcfe	g j c f e	2
jbcehdee	j b c e h d e e	2
gjgfbeh	g j g f b e h	2
ifa	i f a	2
aefh	a e f h	2
cfh	c f h	2
ebijjhh	e b i j j h h	2
bjjh	b j j h	2
bfdgjg	b f d g j g	2
feje	f e j e	2
igdd	i g d d	2
hcdfjagf	h c d f j a g f	2
faf	f a f	2
gfgjcefg	g f g j c e f g	2
dfhjddfb	d f h j d d f b	2
deeaf	d e e a f	2
iec	i e c	2
hdha	h d h a	2
dgefb	d g e f b	2
cie	c i e	2
jefdgb	j e f d g b	2
gjdigefb	g j d i g e f b	2
cffh	c f f h	2
ghbeghdf	g h b e g h d f	2
ibb	i b b	2
bifjfjgi	b i f j f j g i	2
fbcdchib	f b c d c h i b	2
egjf	e g j f	2
ffj	f f j	2
iffgiebe	i f f g i e b e	2
fgg	f g g	2
egebbec	e g e b b e c	2
haiigadd	h a i i g a d d	2
jhg	j h g	2
ggaf	g g a f	2
dfiebj	d f i e b j	2
abaj	a b a j	2
cfcd	c f c d	2
cigjja	c i g j j a	2
fcafjfdc	f c a f j f d c	2
agbjeje	a g b j e j e	2
daiieb	d a i i e b	2
cjbbig	c j b b i g	2
dfigdgdd	d f i g d g d d	2
fcgaf	f c g a f	2
jbhcjjd	j b h c j j d	2
fdb	f d b	2
hcchi	h c c h i	2
cdbibfi	c d b i b f i	2
dbbcejec	d b b c e j e c	2
cdgfaejj	c d g f a e j j	2
fdbcif	f d b c i f	2
ecbie	e c b i e	2
ifdjfa	i f d j f a	2
hfcefjdj	h f c e f j d j	2
gbafdeb	g b a f d e b	2
ijjfehi	i j j f e h i	2
jbijjg	j b i j j g	2
idhehcg	i d h e h c g	2
cejdbhib	c e j d b h i b	2
cgeaff	c g e a f f	2
dhabfeh	d h a b f e h	2
chbia	c h b i a	2
jce	j c e	2
cbchfa	c b c h f a	2
chgcg	c h g c g	2
fhihbf	f h i h b f	1
cjfgg	c j f g g	1
bcbihi	b c b i h i	1
eeih	e e i h	1
edefddd	e d e f d d d	1
fag	f a g	1
igccgib	i g c c g i b	1
gabjaae	g a b j a a e	1
fjibh	f j i b h	1
jhh	j h h	1
jga	j g a	1
aaibh	a a i b h	1
jbaca	j b a c a	1
hgieb	h g i e b	1
fjh	f j h	1
ibhej	i b h e j	1
gfjgfieg	g f j g f i e g	1
jaajfggj	j a a j f g g j	1
ijge	i j g e	1
dbifdf	d b i f d f	1
jedgd	j e d g d	1
ejbfadaf	e j b f a d a f	1
cdeedba	c d e e d b a	1
dfggi	d f g g i	1
debcfje	d e b c f j e	1
fccdgcb	f c c d g c b	1
edcf	e d c f	1
diciii	d i c i i i	1
dfbdjc	d f b d j c	1
bejfagg	b e j f a g g	1
jjdjgcg	j j d j g c g	1
gdadhhaf	g d a d h h a f	1
gbg	g b g	1
gga	g g a	1
fjdj	f j d j	1
acjd	a c j d	1
iig	i i g	1
jcibdc	j c i b d c	1
cibij	c i b i j	1
ddjja	d d j j a	1
hdiehd	h d i e h d	1
adagh	a d a g h	1
aebgbf	a e b g b f	1
jjdadbgb	j j d a d b g b	1
fcggdbi	f c g g d b i	1
bbgei	b b g e i	1
cdffjfgc	c d f f j f g c	1
egdiadi	e g d i a d i	1
cda	c d a	1
jcdhf	j c d h f	1
higai	h i g a i	1
hfbga	h f b g a	1
cijiicg	c i j i i c g	1
bgiief	b g i i e f	1
ebac	e b a c	1
eiadg	e i a d g	1
ghbd	g h b d	1
ideaggh	i d e a g g h	1
dhcehdj	d h c e h d j	1
ecegfa	e c e g f a	1
eeba	e e b a	1
bgac	b g a c	1
gdcdche	g d c d c h e	1
aeaab	a e a a b	1
gcjce	g c j c e	1
ifdbff	i f d b f f	1
bea	b e a	1
djbgbccd	d j b g b c c d	1
ifef	i f e f	1
gdedd	g d e d d	1
edbebbaf	e d b e b b a f	1
dfjjahcd	d f j j a h c d	1
jibidae	j i b i d a e	1
hacig	h a c i g	1
jbdeg	j b d e g	1
bbhhhehg	b b h h h e h g	1
fbe	f b e	1
fjic	f j i c	1
gbfjbe	g b f j b e	1
dcgghda	d c g g h d a	1
daibii	d a i b i i	1
ceb	c e b	1
cahghga	c a h g h g a	1
hghaajfh	h g h a a j f h	1
ehb	e h b	1
ecdg	e c d g	1
gcedjbj	g c e d j b j	1
gecebdcd	g e c e b d c d	1
edg	e d g	1
ede	e d e	1
bifjg	b i f j g	1
jbghfe	j b g h f e	1
hfhdj	h f h d j	1
fbhafcb	f b h a f c b	1
cjcha	c j c h a	1
bci	b c i	1
diadfeg	d i a d f e g	1
abjfd	a b j f d	1
dddifa	d d d i f a	1
bbfcji	b b f c j i	1
fej	f e j	1
igifbf	i g i f b f	1
dic	d i c	1
bdjehgjg	b d j e h g j g	1
gdaidia	g d a i d i a	1
ebejbgjh	e b e j b g j h	1
faha	f a h a	1
ifabbf	i f a b b f	1
dahf	d a h f	1
aaaj	a a a j	1
jaih	j a i h	1
ijdb	i j d b	1
jadgei	j a d g e i	1
dbiif	d b i i f	1
hgage	h g a g e	1
jfa	j f a	1
gagbi	g a g b i	1
fchcciad	f c h c c i a d	1
gghdjbh	g g h d j b h	1
afa	a f a	1
cbjfbc	c b j f b c	1
fchh	f c h h	1
agf	a g f	1
gccc	g c c c	1
jfcidbi	j f c i d b i	1
bdcbie	b d c b i e	1
beefjhd	b e e f j h d	1
dfadbhbg	d f a d b h b g	1
feai	f e a i	1
djdc	d j d c	1
gfd	g f d	1
ghcjida	g h c j i d a	1
ddaj	d d a j	1
gah	g a h	1
jeigbhdj	j e i g b h d j	1
ijjd	i j j d	1
fiabi	f i a b i	1
bfdfhcjf	b f d f h c j f	1
cef	c e f	1
bbgejaig	b b g e j a i g	1
bgihb	b g i h b	1
cec	c e c	1
eaj	e a j	1
ahhdih	a h h d i h	1
ahbgib	a h b g i b	1
gbcddcef	g b c d d c e f	1
dabfidjf	d a b f i d j f	1
didhd	d i d h d	1
hgjce	h g j c e	1
ibbefd	i b b e f d	1
dgbifi	d g b i f i	1
gddehbih	g d d e h b i h	1
hcibaei	h c i b a e i	1
ieg	i e g	1
iegcfddf	i e g c f d d f	1
bdeihifc	b d e i h i f c	1
ifjiggah	i f j i g g a h	1
fghbc	f g h b c	1
fjcch	f j c c h	1
hfee	h f e e	1
cacfdh	c a c f d h	1
ibhjh	i b h j h	1
cheff	c h e f f	1
bbai	b b a i	1
cbcei	c b c e i	1
heiedeh	h e i e d e h	1
ejaedjah	e j a e d j a h	1
egch	e g c h	1
dbcafh	d b c a f h	1
cgcbjh	c g c b j h	1
cej	c e j	1
cjbdd	c j b d d	1
fbdh	f b d h	1
dgf	d g f	1
aci	a c i	1
igdfcaj	i g d f c a j	1
icf	i c f	1
ghjhjigi	g h j h j i g i	1
ehcbc	e h c b c	1
abbgafda	a b b g a f d a	1
iea	i e a	1
ccbjb	c c b j b	1
ihhag	i h h a g	1
ifaaaj	i f a a a j	1
cfheg	c f h e g	1
fhfcaef	f h f c a e f	1
aifjb	a i f j b	1
dida	d i d a	1
eii	e i i	1
ibbfcbdi	i b b f c b d i	1
aeiad	a e i a d	1
bii	b i i	1
baggbd	b a g g b d	1
dhhfjjj	d h h f j j j	1
cbcg	c b c g	1
fbbaf	f b b a f	1
ecbhggc	e c b h g g c	1
dgfaegd	d g f a e g d	1
fecjijcf	f e c j i j c f	1
dbgagb	d b g a g b	1
ecicc	e c i c c	1
cdjb	c d j b	1
ggch	g g c h	1
aij	a i j	1
ffedgc	f f e d g c	1
ihhgh	i h h g h	1
idfiiije	i d f i i i j e	1
ihe	i h e	1
ihfj	i h f j	1
jibfc	j i b f c	1
gighieg	g i g h i e g	1
fjbfab	f j b f a b	1
ghcchhf	g h c c h h f	1
bjbgi	b j b g i	1
jcag	j c a g	1
iebdf	i e b d f	1
ibbe	i b b e	1
ccj	c c j	1
eghebb	e g h e b b	1
fdfcbfcf	f d f c b f c f	1
adj	a d j	1
ejifjf	e j i f j f	1
jgajbbff	j g a j b b f f	1
facbcf	f a c b c f	1
jjdjjce	j j d j j c e	1
fbg	f b g	1
cejd	c e j d	1
babdifh	b a b d i f h	1
gfdhggjc	g f d h g g j c	1
cecabc	c e c a b c	1
ajbcejca	a j b c e j c a	1
gaghcbi	g a g h c b i	1
fcacgi	f c a c g i	1
dji	d j i	1
gfche	g f c h e	1
diijfdf	d i i j f d f	1
ihbe	i h b e	1
fcieicib	f c i e i c i b	1
cdigga	c d i g g a	1
gbhjcd	g b h j c d	1
ibee	i b e e	1
cfaicb	c f a i c b	1
giachc	g i a c h c	1
begjgbfb	b e g j g b f b	1
fbchfcd	f b c h f c d	1
cied	c i e d	1
heheffab	h e h e f f a b	1
ajc	a j c	1
fajj	f a j j	1
hifg	h i f g	1
cfc	c f c	1
gijfjh	g i j f j h	1
diejeief	d i e j e i e f	1
headhcdf	h e a d h c d f	1
fjhdee	f j h d e e	1
jcjfj	j c j f j	1
cahg	c a h g	1
eac	e a c	1
aiiehhhe	a i i e h h h e	1
jifh	j i f h	1
daihgb	d a i h g b	1
ibiih	i b i i h	1
bjaf	b j a f	1
cedjeac	c e d j e a c	1
debja	d e b j a	1
dhidce	d h i d c e	1
bbhac	b b h a c	1
efadgaj	e f a d g a j	1
bcejii	b c e j i i	1
bigii	b i g i i	1
gii	g i i	1
dcjj	d c j j	1
dhchdh	d h c h d h	1
ghh	g h h	1
bdgi	b d g i	1
afh	a f h	1
cibeh	c i b e h	1
ghgebcj	g h g e b c j	1
jgbj	j g b j	1
ibffa	i b f f a	1
cfjaed	c f j a e d	1
ebdahhci	e b d a h h c i	1
bjdf	b j d f	1
ideh	i d e h	1
jbhbbfg	j b h b b f g	1
dhcadgei	d h c a d g e i	1
dfgaghbi	d f g a g h b i	1
ejbgch	e j b g c h	1
cfabcia	c f a b c i a	1
cdce	c d c e	1
cgdjfbj	c g d j f b j	1
gfijc	g f i j c	1
jbjidja	j b j i d j a	1
hdf	h d f	1
hiiaahic	h i i a a h i c	1
habcja	h a b c j a	1
hfgib	h f g i b	1
bae	b a e	1
agid	a g i d	1
gfcgi	g f c g i	1
aja	a j a	1
eeb	e e b	1
ajjb	a j j b	1
iji	i j i	1
ica	i c a	1
giecajd	g i e c a j d	1
eaffhdf	e a f f h d f	1
gbbfj	g b b f j	1
hed	h e d	1
dcj	d c j	1
fighf	f i g h f	1
dhea	d h e a	1
dadcjb	d a d c j b	1
fcefcjh	f c e f c j h	1
gcghjaeb	g c g h j a e b	1
egeii	e g e i i	1
fdag	f d a g	1
jec	j e c	1
chfghii	c h f g h i i	1
jdc	j d c	1
gfjideb	g f j i d e b	1
ffiifd	f f i i f d	1
eecdb	e e c d b	1
aheciid	a h e c i i d	1
bdjjedhf	b d j j e d h f	1
gieh	g i e h	1
jgbc	j g b c	1
jbajicfb	j b a j i c f b	1
eej	e e j	1
afdjga	a f d j g a	1
icbfaij	i c b f a i j	1
ajdd	a j d d	1
ibedb	i b e d b	1
hei	h e i	1
gdjb	g d j b	1
aejjfddd	a e j j f d d d	1
hcejc	h c e j c	1
ggccf	g g c c f	1
bjajeadc	b j a j e a d c	1
bfbg	b f b g	1
jefaaeei	j e f a a e e i	1
hgfg	h g f g	1
ehhi	e h h i	1
eaigc	e a i g c	1
gjed	g j e d	1
eaabijjh	e a a b i j j h	1
aggefdi	a g g e f d i	1
aajgf	a a j g f	1
feefge	f e e f g e	1
hdccij	h d c c i j	1
dfbidc	d f b i d c	1
adfbaj	a d f b a j	1
gdi	g d i	1
dacgabh	d a c g a b h	1
eabacgbd	e a b a c g b d	1
cfgebf	c f g e b f	1
bfcbece	b f c b e c e	1
hdi	h d i	1
efijcajj	e f i j c a j j	1
ghcaia	g h c a i a	1
egd	e g d	1
fegjifc	f e g j i f c	1
bihfh	b i h f h	1
gei	g e i	1
ihdj	i h d j	1
fhbbbc	f h b b b c	1
aacdiedj	a a c d i e d j	1
dda	d d a	1
iddd	i d d d	1
agecg	a g e c g	1
eeebcgj	e e e b c g j	1
iff	i f f	1
ejh	e j h	1
iadddi	i a d d d i	1
djebd	d j e b d	1
dgbfcfhc	d g b f c f h c	1
cdfaebea	c d f a e b e a	1
ffbaefjf	f f b a e f j f	1
dfgdebih	d f g d e b i h	1
jibcjaed	j i b c j a e d	1
bejec	b e j e c	1
gjjc	g j j c	1
cjgh	c j g h	1
aica	a i c a	1
bhgabie	b h g a b i e	1
dccjeai	d c c j e a i	1
eigg	e i g g	1
caba	c a b a	1
aacj	a a c j	1
dgdad	d g d a d	1
dech	d e c h	1
ajgjc	a j g j c	1
cgchbi	c g c h b i	1
gdgffdef	g d g f f d e f	1
jdjbcid	j d j b c i d	1
cheeibd	c h e e i b d	1
iefadaga	i e f a d a g a	1
edfabbe	e d f a b b e	1
ghffaei	g h f f a e i	1
fbeij	f b e i j	1
aiabad	a i a b a d	1
gbaih	g b a i h	1
igaja	i g a j a	1
gaigi	g a i g i	1
ihhef	i h h e f	1
hefhbh	h e f h b h	1
ijjiec	i j j i e c	1
fdifibcj	f d i f i b c j	1
bjdaj	b j d a j	1
eaejije	e a e j i j e	1
dhgbhjif	d h g b h j i f	1
cbfjc	c b f j c	1
fad	f a d	1
difb	d i f b	1
efbgddf	e f b g d d f	1
ibaji	i b a j i	1
cdhic	c d h i c	1
cbaafb	c b a a f b	1
acd	a c d	1
acejaj	a c e j a j	1
cjecjjhh	c j e c j j h h	1
bdhgc	b d h g c	1
cja	c j a	1
jehegga	j e h e g g a	1
fhdaggd	f h d a g g d	1
abhf	a b h f	1
ijbcac	i j b c a c	1
eeaddid	e e a d d i d	1
jdhjgjg	j d h j g j g	1
fbf	f b f	1
acgici	a c g i c i	1
eia	e i a	1
eiggjh	e i g g j h	1
ddidj	d d i d j	1
ihiab	i h i a b	1
cjfffej	c j f f f e j	1
fba	f b a	1
cgb	c g b	1
deee	d e e e	1
gjbjfgd	g j b j f g d	1
bajcjahh	b a j c j a h h	1
cdafejg	c d a f e j g	1
bacj	b a c j	1
aacifi	a a c i f i	1
cbbggjbg	c b b g g j b g	1
gac	g a c	1
habeic	h a b e i c	1
ggd	g g d	1
igbbiji	i g b b i j i	1
egae	e g a e	1
eehj	e e h j	1
chjd	c h j d	1
hjjf	h j j f	1
dbaj	d b a j	1
hee	h e e	1
hiabe	h i a b e	1
bcgbh	b c g b h	1
gdfc	g d f c	1
fjiig	f j i i g	1
bhdha	b h d h a	1
hciddceh	h c i d d c e h	1
fhhgfc	f h h g f c	1
jdgfe	j d g f e	1
dhhjdbia	d h h j d b i a	1
bfachj	b f a c h j	1
fighid	f i g h i d	1
fieddbcc	f i e d d b c c	1
cdccd	c d c c d	1
dgc	d g c	1
iihdc	i i h d c	1
cbhdbff	c b h d b f f	1
acjjbba	a c j j b b a	1
gjghgi	g j g h g i	1
igi	i g i	1
bdbbbbeb	b d b b b b e b	1
dhfd	d h f d	1
haeeihh	h a e e i h h	1
gejegbfg	g e j e g b f g	1
gggaai	g g g a a i	1
faah	f a a h	1
cahgdfc	c a h g d f c	1
fhd	f h d	1
dfecfjfi	d f e c f j f i	1
gffjcgji	g f f j c g j i	1
eaa	e a a	1
eji	e j i	1
ddfabd	d d f a b d	1
jhfdcfh	j h f d c f h	1
fgfifb	f g f i f b	1
hah	h a h	1
bdjc	b d j c	1
gfeeg	g f e e g	1
accch	a c c c h	1
agcfjja	a g c f j j a	1
dhggcea	d h g g c e a	1
ccce	c c c e	1
hcfhg	h c f h g	1
deacgddb	d e a c g d d b	1
cedb	c e d b	1
cdcgbh	c d c g b h	1
jfhf	j f h f	1
adag	a d a g	1
dhdbdf	d h d b d f	1
gghbdhfd	g g h b d h f d	1
iejfgefb	i e j f g e f b	1
fgb	f g b	1
aejfjjba	a e j f j j b a	1
dfcj	d f c j	1
ccbfchje	c c b f c h j e	1
eaaeje	e a a e j e	1
afdache	a f d a c h e	1
gjg	g j g	1
diaicei	d i a i c e i	1
ifd	i f d	1
ahhgha	a h h g h a	1
jfhegd	j f h e g d	1
iagdac	i a g d a c	1
dcgadfc	d c g a d f c	1
aibg	a i b g	1
jfjcg	j f j c g	1
bhif	b h i f	1
fieehjj	f i e e h j j	1
gicia	g i c i a	1
jeae	j e a e	1
agc	a g c	1
ejfebf	e j f e b f	1
ibhjhif	i b h j h i f	1
jbia	j b i a	1
idbi	i d b i	1
ieb	i e b	1
dahgfa	d a h g f a	1
ceacje	c e a c j e	1
dhei	d h e i	1
fjdfijae	f j d f i j a e	1
bjd	b j d	1
bfhaffia	b f h a f f i a	1
ghb	g h b	1
didfiida	d i d f i i d a	1
baebf	b a e b f	1
dbcig	d b c i g	1
chfbaejj	c h f b a e j j	1
eahiji	e a h i j i	1
jhfj	j h f j	1
cgjiajdi	c g j i a j d i	1
jjbibjd	j j b i b j d	1
egdjbcd	e g d j b c d	1
cedga	c e d g a	1
edjcgbc	e d j c g b c	1
fadega	f a d e g a	1
fdf	f d f	1
jejcdec	j e j c d e c	1
hgchdi	h g c h d i	1
dcdi	d c d i	1
hhb	h h b	1
fhjfecg	f h j f e c g	1
effeihj	e f f e i h j	1
fibfhd	f i b f h d	1
jhiicf	j h i i c f	1
ghgfcaa	g h g f c a a	1
aec	a e c	1
iadibii	i a d i b i i	1
hadb	h a d b	1
jffgajd	j f f g a j d	1
iccg	i c c g	1
ddfh	d d f h	1
fajaf	f a j a f	1
beb	b e b	1
fhie	f h i e	1
ggf	g g f	1
cibgaea	c i b g a e a	1
gdh	g d h	1
dhaaah	d h a a a h	1
ijjafidh	i j j a f i d h	1
ffbif	f f b i f	1
gdicghc	g d i c g h c	1
ibc	i b c	1
cdb	c d b	1
fbhg	f b h g	1
caace	c a a c e	1
ceh	c e h	1
bgdb	b g d b	1
bha	b h a	1
agdfjjaa	a g d f j j a a	1
hcha	h c h a	1
icdf	i c d f	1
bhejjdg	b h e j j d g	1
chfc	c h f c	1
djijcaif	d j i j c a i f	1
ifhi	i f h i	1
eai	e a i	1
ibdeeabd	i b d e e a b d	1
bhgdajci	b h g d a j c i	1
gfahee	g f a h e e	1
dfgecd	d f g e c d	1
fbjbfhh	f b j b f h h	1
ddjgfga	d d j g f g a	1
feib	f e i b	1
edh	e d h	1
ejjhhaab	e j j h h a a b	1
aiaajha	a i a a j h a	1
igadeiea	i g a d e i e a	1
iijbegi	i i j b e g i	1
gacddi	g a c d d i	1
gbd	g b d	1
gjcdef	g j c d e f	1
agbfj	a g b f j	1
fcaifced	f c a i f c e d	1
gab	g a b	1
afiacc	a f i a c c	1
jjf	j j f	1
bgdfcah	b g d f c a h	1
fhjdgdd	f h j d g d d	1
dggacja	d g g a c j a	1
