hehf	h e h f	789
efiha	e f i h a	292
ga	g a	239
hde	h d e	223
hiihfh	h i i h f h	213
idfj	i d f j	201
hih	h i h	96
ggf	g g f	94
bddd	b d d d	92
ajh	a j h	76
jji	j j i	76
iceebgh	i c e e b g h	66
jejhgdjh	j e j h g d j h	53
bc	b c	46
dj	d j	46
jbbdhi	j b b d h i	36
hgdfhja	h g d f h j a	35
ghjdacg	g h j d a c g	35
jfhbiif	j f h b i i f	34
de	d e	34
fchhhhff	f c h h h h f f	26
beceffb	b e c e f f b	24
dddhae	d d d h a e	23
hffih	h f f i h	22
hi	h i	22
fhhecie	f h h e c i e	21
gj	g j	20
aid	a i d	19
bh	b h	18
hhbfb	h h b f b	18
bhec	b h e c	18
ccfed	c c f e d	18
ejhaihh	e j h a i h h	17
hggddh	h g g d d h	17
fjbci	f j b c i	15
iaj	i a j	15
bfieh	b f i e h	14
ficg	f i c g	13
fhcjhg	f h c j h g	12
jgb	j g b	12
gec	g e c	12
ccjhaba	c c j h a b a	11
dca	d c a	11
ddaihb	d d a i h b	11
ieejh	i e e j h	11
ifa	i f a	11
geh	g e h	11
djedd	d j e d d	11
ebhb	e b h b	11
ciaeg	c i a e g	10
fiibe	f i i b e	10
igiedh	i g i e d h	10
iecce	i e c c e	10
eegh	e e g h	10
fdgeb	f d g e b	10
ahfh	a h f h	10
aafe	a a f e	10
did	d i d	10
gchee	g c h e e	9
dfha	d f h a	9
aejijg	a e j i j g	9
fiedh	f i e d h	9
jacfdfg	j a c f d f g	9
abhe	a b h e	9
ij	i j	9
fdib	f d i b	9
cf	c f	9
jiihhjbe	j i i h h j b e	9
ej	e j	8
ejhh	e j h h	8
gbajbh	g b a j b h	8
bhcgi	b h c g i	8
dijde	d i j d e	8
habfbggd	h a b f b g g d	8
eehhei	e e h h e i	8
ceahh	c e a h h	8
jhdeg	j h d e g	8
cgh	c g h	8
jhhh	j h h h	8
abehe	a b e h e	8
jcidh	j c i d h	8
abc	a b c	7
fdhei	f d h e i	7
ibhh	i b h h	7
dbhjdfa	d b h j d f a	7
edgff	e d g f f	7
cb	c b	7
acgjf	a c g j f	7
bgg	b g g	7
cheh	c h e h	7
fggcg	f g g c g	7
afeea	a f e e a	7
gcdddh	g c d d d h	7
ehighc	e h i g h c	7
cdchaf	c d c h a f	7
hhbghd	h h b g h d	7
ciij	c i i j	6
gfbidi	g f b i d i	6
fia	f i a	6
ach	a c h	6
iefg	i e f g	6
aca	a c a	6
gge	g g e	6
ahedhf	a h e d h f	6
gfha	g f h a	6
igciafh	i g c i a f h	6
bfgd	b f g d	6
iagd	i a g d	6
dhd	d h d	6
ibii	i b i i	6
eje	e j e	6
bgehed	b g e h e d	6
jhfjeieh	j h f j e i e h	6
fib	f i b	6
bfggihje	b f g g i h j e	6
bgefhh	b g e f h h	6
hch	h c h	6
iagidcfe	i a g i d c f e	5
hjhdid	h j h d i d	5
feedii	f e e d i i	5
dcbbea	d c b b e a	5
deibg	d e i b g	5
acih	a c i h	5
ecbf	e c b f	5
fhfih	f h f i h	5
hgdif	h g d i f	5
gieda	g i e d a	5
bbhj	b b h j	5
cegjje	c e g j j e	5
jigg	j i g g	5
fig	f i g	5
jgd	j g d	5
eiedhe	e i e d h e	5
hciie	h c i i e	5
hhedgc	h h e d g c	5
bgge	b g g e	5
cd	c d	5
hhfahjd	h h f a h j d	4
jadhfffh	j a d h f f f h	4
ggchf	g g c h f	4
bcejedjb	b c e j e d j b	4
fajfe	f a j f e	4
ced	c e d	4
ehh	e h h	4
eeg	e e g	4
aebhcd	a e b h c d	4
bhheg	b h h e g	4
chggbiid	c h g g b i i d	4
ihheeg	i h h e e g	4
jfffh	j f f f h	4
bea	b e a	4
ggjfh	g g j f h	4
ijheijd	i j h e i j d	4
gbh	g b h	4
dfheici	d f h e i c i	4
gedhdeh	g e d h d e h	4
edfh	e d f h	4
cgbgeh	c g b g e h	4
fgj	f g j	4
cjegia	c j e g i a	4
jadbbe	j a d b b e	4
fihge	f i h g e	4
hieficbh	h i e f i c b h	4
hee	h e e	4
ejidjg	e j i d j g	4
cgfhh	c g f h h	4
fihd	f i h d	4
deh	d e h	4
bfag	b f a g	4
jjffacd	j j f f a c d	4
fcjgcgdf	f c j g c g d f	4
hhba	h h b a	4
cff	c f f	4
bjia	b j i a	4
ffhda	f f h d a	4
fcfd	f c f d	4
aje	a j e	4
edb	e d b	4
aaegi	a a e g i	3
ggd	g g d	3
haiehj	h a i e h j	3
chi	c h i	3
bgaf	b g a f	3
higd	h i g d	3
if	i f	3
diaabic	d i a a b i c	3
gdid	g d i d	3
iebdj	i e b d j	3
hfbdbba	h f b d b b a	3
jjb	j j b	3
defda	d e f d a	3
bghceh	b g h c e h	3
cbacah	c b a c a h	3
gejj	g e j j	3
ahhe	a h h e	3
dechh	d e c h h	3
eji	e j i	3
iceh	i c e h	3
fcgeh	f c g e h	3
afhfhccd	a f h f h c c d	3
bcjhab	b c j h a b	3
cjc	c j c	3
iahjje	i a h j j e	3
cjje	c j j e	3
dbaaacd	d b a a a c d	3
cachfhh	c a c h f h h	3
jhihad	j h i h a d	3
ajdbf	a j d b f	3
dcfbf	d c f b f	3
eaeg	e a e g	3
ccbjjj	c c b j j j	3
dcihhha	d c i h h h a	3
gjedh	g j e d h	3
jciii	j c i i i	3
aieaae	a i e a a e	3
echj	e c h j	3
ehcihfj	e h c i h f j	3
dhdb	d h d b	3
ihjfh	i h j f h	3
eabcc	e a b c c	3
fhgiigf	f h g i i g f	3
ggcjj	g g c j j	3
ihhhd	i h h h d	3
bgc	b g c	3
cjiih	c j i i h	3
dcfdigd	d c f d i g d	3
fad	f a d	3
gedgd	g e d g d	3
eihgfhgg	e i h g f h g g	3
hdgc	h d g c	3
dbeefde	d b e e f d e	3
fja	f j a	3
cge	c g e	3
adf	a d f	3
ecbh	e c b h	3
ggjj	g g j j	3
befbhhd	b e f b h h d	3
fahed	f a h e d	3
bgcje	b g c j e	3
fbfef	f b f e f	3
igfc	i g f c	3
adgh	a d g h	3
dhadh	d h a d h	3
iadhf	i a d h f	3
ege	e g e	3
ddd	d d d	3
ggfd	g g f d	3
hfgch	h f g c h	3
hjhih	h j h i h	3
adjaec	a d j a e c	3
fjj	f j j	3
hja	h j a	2
fejfcajh	f e j f c a j h	2
aeachdf	a e a c h d f	2
jbbghb	j b b g h b	2
ghij	g h i j	2
dddccigb	d d d c c i g b	2
cha	c h a	2
bhb	b h b	2
jjchi	j j c h i	2
hjabfehh	h j a b f e h h	2
gfb	g f b	2
hdeh	h d e h	2
ebf	e b f	2
iaje	i a j e	2
cjf	c j f	2
cbjf	c b j f	2
ffcfffc	f f c f f f c	2
ifh	i f h	2
geeahe	g e e a h e	2
ia	i a	2
bhfcfic	b h f c f i c	2
eeeieh	e e e i e h	2
bjaej	b j a e j	2
adicj	a d i c j	2
ccacbf	c c a c b f	2
gahbdbj	g a h b d b j	2
hgjacca	h g j a c c a	2
bcgghcej	b c g g h c e j	2
bab	b a b	2
hchjjh	h c h j j h	2
fgehife	f g e h i f e	2
chh	c h h	2
cfajcgbh	c f a j c g b h	2
hdej	h d e j	2
cjjcc	c j j c c	2
heiabhc	h e i a b h c	2
ahcej	a h c e j	2
eeih	e e i h	2
edj	e d j	2
gibhh	g i b h h	2
bbcgh	b b c g h	2
hebifaji	h e b i f a j i	2
gdehdc	g d e h d c	2
bbhjgh	b b h j g h	2
aedihej	a e d i h e j	2
cifed	c i f e d	2
jgahc	j g a h c	2
gchhcfi	g c h h c f i	2
hjhj	h j h j	2
hajcdggh	h a j c d g g h	2
jigh	j i g h	2
fbhb	f b h b	2
hfbbdad	h f b b d a d	2
iadjh	i a d j h	2
ggdbdfb	g g d b d f b	2
jhihbif	j h i h b i f	2
eajd	e a j d	2
iec	i e c	2
ihghi	i h g h i	2
cgdfih	c g d f i h	2
bee	b e e	2
efjhbch	e f j h b c h	2
fg	f g	2
eadjg	e a d j g	2
fe	f e	2
iabaehj	i a b a e h j	2
hgbcddha	h g b c d d h a	2
cech	c e c h	2
fgfgbh	f g f g b h	2
achgh	a c h g h	2
hgj	h g j	2
hhc	h h c	2
ie	i e	2
cheii	c h e i i	2
jbgh	j b g h	2
hfiaib	h f i a i b	2
gijhdgdb	g i j h d g d b	2
djeecf	d j e e c f	2
abcah	a b c a h	2
jbd	j b d	2
jefdhih	j e f d h i h	2
icb	i c b	2
bb	b b	2
jifh	j i f h	2
gcaadh	g c a a d h	2
fehebgjj	f e h e b g j j	2
ghdefcd	g h d e f c d	2
gcbahh	g c b a h h	2
iijbah	i i j b a h	2
jib	j i b	2
hfdejf	h f d e j f	2
ebi	e b i	2
fhhaaie	f h h a a i e	2
hhjfec	h h j f e c	2
bhabidec	b h a b i d e c	2
bdib	b d i b	2
jfei	j f e i	2
ceehgda	c e e h g d a	2
iciefc	i c i e f c	2
ghd	g h d	2
def	d e f	2
cijjcc	c i j j c c	2
ibh	i b h	2
fcahjh	f c a h j h	2
ahf	a h f	2
ddejgghi	d d e j g g h i	2
dhee	d h e e	2
fcbbebf	f c b b e b f	2
cheaf	c h e a f	2
ddhif	d d h i f	2
ggahd	g g a h d	2
eabahcb	e a b a h c b	2
bgj	b g j	2
fhbdh	f h b d h	2
jehahda	j e h a h d a	2
gdi	g d i	2
hjiif	h j i i f	2
jefijgbe	j e f i j g b e	2
ahg	a h g	2
afgaef	a f g a e f	2
eiih	e i i h	2
ejecf	e j e c f	2
bhghjdgd	b h g h j d g d	2
ihha	i h h a	2
aaghe	a a g h e	2
jcj	j c j	2
dgbdidh	d g b d i d h	2
fef	f e f	2
ffchaijd	f f c h a i j d	2
cgadh	c g a d h	2
iadibh	i a d i b h	2
cfggheg	c f g g h e g	2
jebehjcb	j e b e h j c b	2
hfghe	h f g h e	2
fdhbcfga	f d h b c f g a	2
ifj	i f j	2
badaba	b a d a b a	1
ffhba	f f h b a	1
hcficc	h c f i c c	1
cbiggdje	c b i g g d j e	1
jjehccac	j j e h c c a c	1
djaja	d j a j a	1
facjbcfg	f a c j b c f g	1
dfeiifg	d f e i i f g	1
jbdg	j b d g	1
gjcghhii	g j c g h h i i	1
facchfhe	f a c c h f h e	1
fhhijaa	f h h i j a a	1
jef	j e f	1
acfe	a c f e	1
didhjigf	d i d h j i g f	1
hehdieii	h e h d i e i i	1
biedcfdd	b i e d c f d d	1
giagh	g i a g h	1
cggejdf	c g g e j d f	1
fdi	f d i	1
jebdh	j e b d h	1
jgaici	j g a i c i	1
aeb	a e b	1
hijihcd	h i j i h c d	1
acchebi	a c c h e b i	1
fjihcge	f j i h c g e	1
ihc	i h c	1
ffjh	f f j h	1
aahdcg	a a h d c g	1
fgdhb	f g d h b	1
cbjig	c b j i g	1
bcaggde	b c a g g d e	1
deedi	d e e d i	1
iiajdge	i i a j d g e	1
hebf	h e b f	1
icifiacg	i c i f i a c g	1
ggbfi	g g b f i	1
dadh	d a d h	1
addfif	a d d f i f	1
dacibb	d a c i b b	1
dehb	d e h b	1
ddbididj	d d b i d i d j	1
gdagag	g d a g a g	1
diahf	d i a h f	1
ghab	g h a b	1
gieajdg	g i e a j d g	1
fcb	f c b	1
efb	e f b	1
iccid	i c c i d	1
ghidcbj	g h i d c b j	1
jadhidj	j a d h i d j	1
dgag	d g a g	1
dgcafadg	d g c a f a d g	1
jgfjjhjd	j g f j j h j d	1
cjg	c j g	1
ggfbad	g g f b a d	1
cebaf	c e b a f	1
gjeeega	g j e e e g a	1
gfebcd	g f e b c d	1
dcehcdia	d c e h c d i a	1
bjaf	b j a f	1
ehe	e h e	1
egj	e g j	1
hfeb	h f e b	1
jedbe	j e d b e	1
jcheeb	j c h e e b	1
hci	h c i	1
aeddied	a e d d i e d	1
ccfiij	c c f i i j	1
jhbh	j h b h	1
cchii	c c h i i	1
fjgaii	f j g a i i	1
gbbbe	g b b b e	1
dhiicic	d h i i c i c	1
dejjeaid	d e j j e a i d	1
ddeje	d d e j e	1
geee	g e e e	1
icc	i c c	1
ghj	g h j	1
hbeb	h b e b	1
gdgfjhe	g d g f j h e	1
chcaafca	c h c a a f c a	1
idi	i d i	1
dbd	d b d	1
cehi	c e h i	1
ahbjh	a h b j h	1
hcbhc	h c b h c	1
edfdgih	e d f d g i h	1
bda	b d a	1
hffeb	h f f e b	1
jaehf	j a e h f	1
dd	d d	1
faa	f a a	1
gdgcbfd	g d g c b f d	1
gcf	g c f	1
ggdbih	g g d b i h	1
aeehfhj	a e e h f h j	1
jcbg	j c b g	1
hhh	h h h	1
dhdahfi	d h d a h f i	1
ddggiggf	d d g g i g g f	1
ghgfah	g h g f a h	1
eabdjiji	e a b d j i j i	1
aicjhjj	a i c j h j j	1
jiic	j i i c	1
eajh	e a j h	1
jci	j c i	1
ebjjb	e b j j b	1
afceejh	a f c e e j h	1
gijdfgb	g i j d f g b	1
abie	a b i e	1
jheggf	j h e g g f	1
fcefe	f c e f e	1
dccfh	d c c f h	1
cidi	c i d i	1
haaa	h a a a	1
fiabchc	f i a b c h c	1
jebid	j e b i d	1
deii	d e i i	1
fcga	f c g a	1
addfcaa	a d d f c a a	1
febh	f e b h	1
ffbfgfib	f f b f g f i b	1
fdia	f d i a	1
aicfjef	a i c f j e f	1
hhcgh	h h c g h	1
bdih	b d i h	1
dia	d i a	1
ihgff	i h g f f	1
eddhc	e d d h c	1
gfiiiccb	g f i i i c c b	1
ccfhbe	c c f h b e	1
cdbicgfi	c d b i c g f i	1
ibcadhd	i b c a d h d	1
fabhehhi	f a b h e h h i	1
jddh	j d d h	1
fdjc	f d j c	1
ijddfdch	i j d d f d c h	1
afbb	a f b b	1
ddhhf	d d h h f	1
dbgh	d b g h	1
agccbj	a g c c b j	1
abbehd	a b b e h d	1
efad	e f a d	1
adefhi	a d e f h i	1
eii	e i i	1
jahfa	j a h f a	1
ebeb	e b e b	1
hghgbieb	h g h g b i e b	1
jgejcfia	j g e j c f i a	1
dhaaf	d h a a f	1
dcdd	d c d d	1
achb	a c h b	1
bgedgdhe	b g e d g d h e	1
eajbf	e a j b f	1
jiifiga	j i i f i g a	1
gedbga	g e d b g a	1
dbc	d b c	1
edifajac	e d i f a j a c	1
bdhchifg	b d h c h i f g	1
jdh	j d h	1
fifeegg	f i f e e g g	1
haiah	h a i a h	1
hafhh	h a f h h	1
bedhae	b e d h a e	1
aah	a a h	1
ecged	e c g e d	1
chejghf	c h e j g h f	1
bjhdah	b j h d a h	1
ajeij	a j e i j	1
hcfbcb	h c f b c b	1
aebij	a e b i j	1
jidiheii	j i d i h e i i	1
fjjfhch	f j j f h c h	1
fhg	f h g	1
ibb	i b b	1
cecea	c e c e a	1
fegag	f e g a g	1
bdiecc	b d i e c c	1
daijhfh	d a i j h f h	1
acaeafb	a c a e a f b	1
gbiajde	g b i a j d e	1
cajg	c a j g	1
bgdjj	b g d j j	1
jeaeb	j e a e b	1
cgdg	c g d g	1
ddhdd	d d h d d	1
eeafhg	e e a f h g	1
ihj	i h j	1
ebceaeba	e b c e a e b a	1
hdab	h d a b	1
ahca	a h c a	1
jchjg	j c h j g	1
igdcbbda	i g d c b b d a	1
idiaghdd	i d i a g h d d	1
ejh	e j h	1
ife	i f e	1
chbcbjb	c h b c b j b	1
ddie	d d i e	1
jidhihdj	j i d h i h d j	1
hagh	h a g h	1
fcbe	f c b e	1
idegjeh	i d e g j e h	1
aiad	a i a d	1
fddfbjfj	f d d f b j f j	1
cfijeafg	c f i j e a f g	1
fhdjbgdh	f h d j b g d h	1
ebbh	e b b h	1
iccacai	i c c a c a i	1
iejdidii	i e j d i d i i	1
bgjfdg	b g j f d g	1
ebggd	e b g g d	1
dgcbddc	d g c b d d c	1
hjdhdb	h j d h d b	1
abjccfg	a b j c c f g	1
dchijiei	d c h i j i e i	1
ddifc	d d i f c	1
adhfbi	a d h f b i	1
eechde	e e c h d e	1
fajhdcf	f a j h d c f	1
difjfbjb	d i f j f b j b	1
jjgijjc	j j g i j j c	1
gfajhe	g f a j h e	1
gce	g c e	1
ajhhf	a j h h f	1
bhhcce	b h h c c e	1
jcg	j c g	1
cga	c g a	1
fged	f g e d	1
ijj	i j j	1
fej	f e j	1
hbjhfbdb	h b j h f b d b	1
ifii	i f i i	1
jaabhci	j a a b h c i	1
gghab	g g h a b	1
gdcg	g d c g	1
gacdgc	g a c d g c	1
heeicgcj	h e e i c g c j	1
abheh	a b h e h	1
gfbgghdd	g f b g g h d d	1
bji	b j i	1
fjeebdi	f j e e b d i	1
cgjbjb	c g j b j b	1
fdebehe	f d e b e h e	1
jcc	j c c	1
iefja	i e f j a	1
jcbfigc	j c b f i g c	1
hcaac	h c a a c	1
fabdce	f a b d c e	1
iiff	i i f f	1
habgbbc	h a b g b b c	1
ffdafj	f f d a f j	1
jfaha	j f a h a	1
bhf	b h f	1
hdi	h d i	1
jbabhhe	j b a b h h e	1
hjce	h j c e	1
iib	i i b	1
cjd	c j d	1
dhcfh	d h c f h	1
jhhcdh	j h h c d h	1
cagd	c a g d	1
ebbh	e b b h	1
ieheidia	i e h e i d i a	1
jaha	j a h a	1
bgfbdihd	b g f b d i h d	1
gajfajbh	g a j f a j b h	1
hfedgcc	h f e d g c c	1
aeahfg	a e a h f g	1
bifh	b i f h	1
ebcbbefc	e b c b b e f c	1
baaedcg	b a a e d c g	1
fddae	f d d a e	1
fggdj	f g g d j	1
ejaejhe	e j a e j h e	1
cifffij	c i f f f i j	1
ebfae	e b f a e	1
acg	a c g	1
hceeca	h c e e c a	1
gjefijb	g j e f i j b	1
afh	a f h	1
ddeg	d d e g	1
aeddie	a e d d i e	1
highdj	h i g h d j	1
ccfj	c c f j	1
jde	j d e	1
cfgiidh	c f g i i d h	1
gcag	g c a g	1
aaa	a a a	1
gajbgic	g a j b g i c	1
jjbcceic	j j b c c e i c	1
begchi	b e g c h i	1
ceeh	c e e h	1
gbjagh	g b j a g h	1
cebhhc	c e b h h c	1
idfifidb	i d f i f i d b	1
ejjidded	e j j i d d e d	1
gdecbi	g d e c b i	1
cc	c c	1
cibaeh	c i b a e h	1
ejcjh	e j c j h	1
gbhbd	g b h b d	1
eheehg	e h e e h g	1
ifijcfbi	i f i j c f b i	1
djeed	d j e e d	1
efjddi	e f j d d i	1
habhjj	h a b h j j	1
jjcigjcc	j j c i g j c c	1
fff	f f f	1
cfe	c f e	1
aiddf	a i d d f	1
hca	h c a	1
hdihbji	h d i h b j i	1
eeae	e e a e	1
jihcbhee	j i h c b h e e	1
hjbfhgcd	h j b f h g c d	1
hif	h i f	1
fjjea	f j j e a	1
jaj	j a j	1
gahce	g a h c e	1
eijh	e i j h	1
biadj	b i a d j	1
ihec	i h e c	1
hcdj	h c d j	1
ggcjdaj	g g c j d a j	1
aajcfcai	a a j c f c a i	1
efdigd	e f d i g d	1
bi	b i	1
hh	h h	1
ecf	e c f	1
efigbifh	e f i g b i f h	1
icgh	i c g h	1
gedh	g e d h	1
jjicbc	j j i c b c	1
hcahg	h c a h g	1
hcahf	h c a h f	1
ihbgga	i h b g g a	1
fgjeigf	f g j e i g f	1
ddcegcig	d d c e g c i g	1
higggjh	h i g g g j h	1
gcdd	g c d d	1
ehgbdgea	e h g b d g e a	1
ce	c e	1
idcaej	i d c a e j	1
ddcfh	d d c f h	1
cihha	c i h h a	1
ibbfdhh	i b b f d h h	1
ifhjbi	i f h j b i	1
ejcfae	e j c f a e	1
cjfgj	c j f g j	1
hfhebc	h f h e b c	1
gbc	g b c	1
dhjfbje	d h j f b j e	1
hcedahgb	h c e d a h g b	1
gba	g b a	1
hbda	h b d a	1
agfd	a g f d	1
jah	j a h	1
ddehh	d d e h h	1
hfdfde	h f d f d e	1
cjhc	c j h c	1
dge	d g e	1
ddibce	d d i b c e	1
gjjccj	g j j c c j	1
igfb	i g f b	1
ecihjg	e c i h j g	1
jgbd	j g b d	1
dffj	d f f j	1
cacgdhjh	c a c g d h j h	1
djjj	d j j j	1
fieidcdd	f i e i d c d d	1
eciihfij	e c i i h f i j	1
hacbjf	h a c b j f	1
hjbhee	h j b h e e	1
dcjbbdbd	d c j b b d b d	1
gef	g e f	1
gefjcfcf	g e f j c f c f	1
ebbf	e b b f	1
ccci	c c c i	1
hbfh	h b f h	1
aicfajd	a i c f a j d	1
jfdahjh	j f d a h j h	1
bgigigei	b g i g i g e i	1
cijhaa	c i j h a a	1
iidgaf	i i d g a f	1
fejh	f e j h	1
eigha	e i g h a	1
hege	h e g e	1
hiaafihd	h i a a f i h d	1
hjggh	h j g g h	1
icbidie	i c b i d i e	1
dgcfd	d g c f d	1
gccfbifd	g c c f b i f d	1
ebcfggb	e b c f g g b	1
dcihhh	d c i h h h	1
cbeebf	c b e e b f	1
cjhhbebf	c j h h b e b f	1
cif	c i f	1
gbeh	g b e h	1
gabfd	g a b f d	1
hacdghc	h a c d g h c	1
bjigf	b j i g f	1
ebg	e b g	1
fjbj	f j b j	1
gbg	g b g	1
eafghcc	e a f g h c c	1
ibbicd	i b b i c d	1
ijeeae	i j e e a e	1
aadg	a a d g	1
abfcgf	a b f c g f	1
idheaj	i d h e a j	1
gcecgac	g c e c g a c	1
gcei	g c e i	1
dfc	d f c	1
cfghi	c f g h i	1
hadjg	h a d j g	1
cefaa	c e f a a	1
bageeh	b a g e e h	1
adeh	a d e h	1
dcacehic	d c a c e h i c	1
idbee	i d b e e	1
ajcfca	a j c f c a	1
jcehh	j c e h h	1
jbi	j b i	1
dhihe	d h i h e	1
ded	d e d	1
chc	c h c	1
adcjf	a d c j f	1
jcbei	j c b e i	1
hcfee	h c f e e	1
begedji	b e g e d j i	1
gagbe	g a g b e	1
adjfdi	a d j f d i	1
agicfh	a g i c f h	1
hbfdhi	h b f d h i	1
beg	b e g	1
ghcab	g h c a b	1
ifjgbga	i f j g b g a	1
hcbaeed	h c b a e e d	1
ejed	e j e d	1
gcaiggh	g c a i g g h	1
jjdh	j j d h	1
ghiidc	g h i i d c	1
ccaggaid	c c a g g a i d	1
adeg	a d e g	1
fgfdcbb	f g f d c b b	1
dbjiiagd	d b j i i a g d	1
didcbjgf	d i d c b j g f	1
hj	h j	1
eehfb	e e h f b	1
hieeji	h i e e j i	1
hhbcbgjj	h h b c b g j j	1
jgeaaah	j g e a a a h	1
giabdgff	g i a b d g f f	1
jjgfe	j j g f e	1
bieddc	b i e d d c	1
ddfbie	d d f b i e	1
ddbhhg	d d b h h g	1
iaah	i a a h	1
facf	f a c f	1
ebggf	e b g g f	1
eb	e b	1
bhcecja	b h c e c j a	1
beeh	b e e h	1
ejfci	e j f c i	1
hfeh	h f e h	1
hhg	h h g	1
bcaiiic	b c a i i i c	1
hedh	h e d h	1
eeagfdid	e e a g f d i d	1
ijfjeea	i j f j e e a	1
hjghhbjc	h j g h h b j c	1
egf	e g f	1
jejjc	j e j j c	1
faecffhc	f a e c f f h c	1
bffb	b f f b	1
fhjgbi	f h j g b i	1
gad	g a d	1
bichae	b i c h a e	1
egege	e g e g e	1
ecehgi	e c e h g i	1
dffhief	d f f h i e f	1
jdfi	j d f i	1
eaachh	e a a c h h	1
adehbhe	a d e h b h e	1
ggg	g g g	1
dggdb	d g g d b	1
fdiicjba	f d i i c j b a	1
bdahehib	b d a h e h i b	1
cjja	c j j a	1
jhcghefi	j h c g h e f i	1
chajha	c h a j h a	1
bdd	b d d	1
aiciji	a i c i j i	1
ghjih	g h j i h	1
jgfb	j g f b	1
jaeaj	j a e a j	1
dae	d a e	1
gbfa	g b f a	1
eiijidfd	e i i j i d f d	1
cceegga	c c e e g g a	1
bjjd	b j j d	1
eahgadd	e a h g a d d	1
jgde	j g d e	1
edfci	e d f c i	1
geegg	g e e g g	1
hjbgj	h j b g j	1
dhchfg	d h c h f g	1
fae	f a e	1
cebij	c e b i j	1
caigfa	c a i g f a	1
hhjbhad	h h j b h a d	1
agi	a g i	1
eaddeg	e a d d e g	1
gfh	g f h	1
ijfghj	i j f g h j	1
ahhjgjbd	a h h j g j b d	1
cdj	c d j	1
hjjdaice	h j j d a i c e	1
jihbbje	j i h b b j e	1
idefca	i d e f c a	1
fechie	f e c h i e	1
icccfcc	i c c c f c c	1
ajchjj	a j c h j j	1
hjffic	h j f f i c	1
jfheig	j f h e i g	1
gfchbbdi	g f c h b b d i	1
gbbich	g b b i c h	1
dcg	d c g	1
cdedcb	c d e d c b	1
biibdaj	b i i b d a j	1
hgac	h g a c	1
geehf	g e e h f	1
bidjbiad	b i d j b i a d	1
gfg	g f g	1
jgiai	j g i a i	1
idiicdaf	i d i i c d a f	1
cdcfj	c d c f j	1
bcahh	b c a h h	1
aaih	a a i h	1
faaaf	f a a a f	1
ejbh	e j b h	1
fci	f c i	1
ecea	e c e a	1
hchhi	h c h h i	1
dhgebj	d h g e b j	1
bihja	b i h j a	1
dic	d i c	1
dga	d g a	1
becddh	b e c d d h	1
jefbg	j e f b g	1
gchaacah	g c h a a c a h	1
jbaegfd	j b a e g f d	1
dcjhacdj	d c j h a c d j	1
egfbhded	e g f b h d e d	1
jjge	j j g e	1
dihhi	d i h h i	1
ebdh	e b d h	1
dghbf	d g h b f	1
gbgh	g b g h	1
ecabfj	e c a b f j	1
fgi	f g i	1
jgdgdbb	j g d g d b b	1
jjbbcjhg	j j b b c j h g	1
dfdhgg	d f d h g g	1
iaebace	i a e b a c e	1
dehgijc	d e h g i j c	1
ebhfb	e b h f b	1
cai	c a i	1
dcc	d c c	1
hhgdi	h h g d i	1
haba	h a b a	1
fffe	f f f e	1
dggaghfj	d g g a g h f j	1
ecfddc	e c f d d c	1
bbcig	b b c i g	1
cdhb	c d h b	1
edjh	e d j h	1
cfi	c f i	1
ahifh	a h i f h	1
bdgj	b d g j	1
cefdghc	c e f d g h c	1
ieacc	i e a c c	1
agjebbfh	a g j e b b f h	1
cgjfig	c g j f i g	1
debd	d e b d	1
adfgfbi	a d f g f b i	1
ijdce	i j d c e	1
dbdaaebi	d b d a a e b i	1
hbeifhi	h b e i f h i	1
dbdeaeba	d b d e a e b a	1
cid	c i d	1
jigacfeh	j i g a c f e h	1
acii	a c i i	1
aijfbgg	a i j f b g g	1
jihhd	j i h h d	1
jicef	j i c e f	1
bbhd	b b h d	1
gjedgag	g j e d g a g	1
jafh	j a f h	1
eehdhfj	e e h d h f j	1
jff	j f f	1
cii	c i i	1
cfch	c f c h	1
hdcih	h d c i h	1
eehcd	e e h c d	1
eccfb	e c c f b	1
ejf	e j f	1
bdhgbehi	b d h g b e h i	1
hjifh	h j i f h	1
aiejaf	a i e j a f	1
ibeab	i b e a b	1
hfb	h f b	1
