iccc	i c c c	1791
cc	c c	1275
j	j	780
eii	e i i	254
f	f	220
ciii	c i i i	189
cii	c i i	183
jbei	j b e i	75
gg	g g	71
h	h	68
b	b	67
ae	a e	56
diceigg	d i c e i g g	55
gf	g f	55
aj	a j	53
c	c	37
ccc	c c c	35
achi	a c h i	35
jidi	j i d i	33
cfc	c f c	28
dgcjhg	d g c j h g	26
ehchi	e h c h i	25
aci	a c i	25
gcjhiii	g c j h i i i	25
hh	h h	25
bc	b c	24
ija	i j a	23
bac	b a c	23
jhc	j h c	22
iciic	i c i i c	22
fih	f i h	22
jfci	j f c i	22
hij	h i j	22
fcdci	f c d c i	21
jgc	j g c	20
ehjc	e h j c	20
jec	j e c	19
hbefif	h b e f i f	19
chhc	c h h c	19
gh	g h	18
agch	a g c h	17
fe	f e	17
cdec	c d e c	17
eji	e j i	17
ffhicii	f f h i c i i	16
bcg	b c g	16
eig	e i g	15
hjiic	h j i i c	15
jcic	j c i c	15
gaiih	g a i i h	15
ccjc	c c j c	15
jh	j h	14
cbi	c b i	14
giccghi	g i c c g h i	14
bchc	b c h c	14
hdccc	h d c c c	13
abfgf	a b f g f	13
gjc	g j c	13
gihfc	g i h f c	13
hffccc	h f f c c c	12
hhj	h h j	12
dci	d c i	12
biihi	b i i h i	11
ggjihg	g g j i h g	11
fecfi	f e c f i	11
abifij	a b i f i j	11
jic	j i c	11
hcgihie	h c g i h i e	11
cddj	c d d j	10
fci	f c i	10
ecac	e c a c	10
eahcch	e a h c c h	10
cghc	c g h c	10
ehi	e h i	9
dji	d j i	9
ffi	f f i	9
adaich	a d a i c h	9
jcbicci	j c b i c c i	9
ddhh	d d h h	9
ece	e c e	8
jcdibfic	j c d i b f i c	8
jei	j e i	8
gibidb	g i b i d b	8
jgjc	j g j c	8
chjih	c h j i h	8
jfj	j f j	8
ai	a i	7
ah	a h	7
iid	i i d	7
if	i f	7
ecghi	e c g h i	7
bhji	b h j i	7
cdgigif	c d g i g i f	7
gajhi	g a j h i	7
iibi	i i b i	7
bh	b h	7
jhf	j h f	6
eb	e b	6
ihijjai	i h i j j a i	6
jj	j j	6
fcfbee	f c f b e e	6
eijf	e i j f	6
bicicgc	b i c i c g c	6
abi	a b i	6
jhcjfci	j h c j f c i	6
bj	b j	6
deb	d e b	6
aihih	a i h i h	6
idd	i d d	6
febecf	f e b e c f	5
dciji	d c i j i	5
bii	b i i	5
ibh	i b h	5
adaci	a d a c i	5
faib	f a i b	5
babhc	b a b h c	5
bjjihiig	b j j i h i i g	5
gajcce	g a j c c e	5
gi	g i	5
adfc	a d f c	5
chhj	c h h j	5
jiac	j i a c	5
bbehh	b b e h h	5
db	d b	5
jbc	j b c	5
biccih	b i c c i h	5
heb	h e b	5
aacg	a a c g	5
hjcjc	h j c j c	4
behibh	b e h i b h	4
gbcc	g b c c	4
jbhjchi	j b h j c h i	4
bcbjchc	b c b j c h c	4
cjj	c j j	4
hahiihc	h a h i i h c	4
bhh	b h h	4
afh	a f h	4
ac	a c	4
fgef	f g e f	4
jiihhjha	j i i h h j h a	4
hgc	h g c	4
gjjg	g j j g	4
bej	b e j	4
ahe	a h e	4
jjgh	j j g h	4
gdh	g d h	4
hefifi	h e f i f i	4
jhficc	j h f i c c	4
ababi	a b a b i	4
gihbi	g i h b i	4
fcgic	f c g i c	4
dcj	d c j	4
iaccga	i a c c g a	4
gfbh	g f b h	4
daij	d a i j	4
gci	g c i	4
iegdij	i e g d i j	4
hjecj	h j e c j	4
fiec	f i e c	4
dbecf	d b e c f	4
dcch	d c c h	4
aai	a a i	4
hcdehi	h c d e h i	4
ahdie	a h d i e	4
addih	a d d i h	3
ibbc	i b b c	3
fbaic	f b a i c	3
icf	i c f	3
jhj	j h j	3
bjb	b j b	3
cffj	c f f j	3
aeci	a e c i	3
bji	b j i	3
ighe	i g h e	3
gbdc	g b d c	3
gbb	g b b	3
baigacea	b a i g a c e a	3
jcabchc	j c a b c h c	3
cbc	c b c	3
ceaccjc	c e a c c j c	3
bgbc	b g b c	3
idhbic	i d h b i c	3
diahcj	d i a h c j	3
hihec	h i h e c	3
eich	e i c h	3
agi	a g i	3
iibf	i i b f	3
ceii	c e i i	3
idhhhahg	i d h h h a h g	3
a	a	3
icidc	i c i d c	3
dihc	d i h c	3
jjadi	j j a d i	3
bgcihci	b g c i h c i	3
ebhci	e b h c i	3
eehjca	e e h j c a	3
fhe	f h e	3
afghi	a f g h i	3
facgf	f a c g f	3
jghigg	j g h i g g	3
caghiji	c a g h i j i	3
jfccci	j f c c c i	3
difhfag	d i f h f a g	3
ajji	a j j i	3
geacih	g e a c i h	3
didccc	d i d c c c	3
gdi	g d i	3
edgbc	e d g b c	3
adjgc	a d j g c	3
efjcjiaj	e f j c j i a j	2
ebb	e b b	2
iabif	i a b i f	2
hbhjbcjb	h b h j b c j b	2
cgifb	c g i f b	2
ficbia	f i c b i a	2
jdecccc	j d e c c c c	2
iaeb	i a e b	2
bdh	b d h	2
ghah	g h a h	2
ca	c a	2
icejhh	i c e j h h	2
cfejjg	c f e j j g	2
hae	h a e	2
dc	d c	2
dbchbj	d b c h b j	2
aecc	a e c c	2
jhadgfi	j h a d g f i	2
jjcedh	j j c e d h	2
eejhc	e e j h c	2
hgcf	h g c f	2
bbici	b b i c i	2
cjij	c j i j	2
fbaci	f b a c i	2
jhcdbh	j h c d b h	2
eagcdi	e a g c d i	2
iccghfb	i c c g h f b	2
gigahehh	g i g a h e h h	2
bfg	b f g	2
ggegfhj	g g e g f h j	2
abjf	a b j f	2
icgcihj	i c g c i h j	2
cdaigccc	c d a i g c c c	2
bajhhab	b a j h h a b	2
hiafc	h i a f c	2
dgfghi	d g f g h i	2
jiijeb	j i i j e b	2
jfac	j f a c	2
iicdhcj	i i c d h c j	2
dbhji	d b h j i	2
gjafifga	g j a f i f g a	2
icj	i c j	2
efgice	e f g i c e	2
ibjcbc	i b j c b c	2
dechghi	d e c h g h i	2
ahj	a h j	2
iiacbhh	i i a c b h h	2
iijhcaab	i i j h c a a b	2
fdijhiji	f d i j h i j i	2
giaeh	g i a e h	2
dafjhhi	d a f j h h i	2
dcic	d c i c	2
efaabdih	e f a a b d i h	2
hgfdjh	h g f d j h	2
iggi	i g g i	2
ejj	e j j	2
cbhij	c b h i j	2
cbgcfef	c b g c f e f	2
aagi	a a g i	2
ieaih	i e a i h	2
bdai	b d a i	2
ejhh	e j h h	2
jdfdi	j d f d i	2
bfiiei	b f i i e i	2
bdhgchd	b d h g c h d	2
jgb	j g b	2
ejhejbg	e j h e j b g	2
affa	a f f a	2
caihj	c a i h j	2
fecji	f e c j i	2
dcccc	d c c c c	2
jghc	j g h c	2
cdi	c d i	2
fgehijai	f g e h i j a i	2
bfa	b f a	2
jbfjf	j b f j f	2
baj	b a j	2
jaheiic	j a h e i i c	2
gcc	g c c	2
bghahicb	b g h a h i c b	2
djffcf	d j f f c f	2
ecdi	e c d i	2
dgii	d g i i	2
abcic	a b c i c	2
iei	i e i	2
cdfdjh	c d f d j h	2
gedgcchg	g e d g c c h g	2
adb	a d b	2
abahb	a b a h b	2
jcgcc	j c g c c	2
icd	i c d	2
fdd	f d d	2
baai	b a a i	2
ghgb	g h g b	2
caccg	c a c c g	2
ddhahg	d d h a h g	2
dhi	d h i	2
ibcdfe	i b c d f e	2
gaacdadi	g a a c d a d i	2
iidjh	i i d j h	2
ejdi	e j d i	2
hcf	h c f	2
cahh	c a h h	2
fejc	f e j c	2
hcihb	h c i h b	2
hbh	h b h	2
ihdc	i h d c	2
decgbed	d e c g b e d	2
hjd	h j d	2
aii	a i i	2
dgjci	d g j c i	2
fijaf	f i j a f	2
gjchi	g j c h i	2
jbcecgcc	j b c e c g c c	2
gjgfceh	g j g f c e h	2
jca	j c a	2
aefc	a e f c	2
ahich	a h i c h	2
ebijgh	e b i j g h	2
bjjh	b j j h	2
bfdjjh	b f d j j h	2
feje	f e j e	2
igdj	i g d j	2
cdfjhcf	c d f j h c f	2
af	a f	2
ghgcei	g h g c e i	2
dfhcddfb	d f h c d d f b	2
deec	d e e c	2
adie	a d i e	2
cdee	c d e e	2
diic	d i i c	2
acac	a c a c	2
jefcgi	j e f c g i	2
gjdecib	g j d e c i b	2
fccch	f c c c h	2
ghbcghdf	g h b c g h d f	2
bb	b b	2
bifjicic	b i f j i c i c	2
fdcdceih	f d c d c e i h	2
egha	e g h a	2
ifj	i f j	2
iffiihe	i f f i i h e	2
fgc	f g c	2
egebh	e g e b h	2
haihcidd	h a i h c i d d	2
ihi	i h i	2
ggaj	g g a j	2
dfiig	d f i i g	2
ahaj	a h a j	2
jfcj	j f c j	2
ciejjh	c i e j j h	2
fiaciidc	f i a c i i d c	2
abbhcj	a b b h c j	2
daici	d a i c i	2
cjbic	c j b i c	2
daigdcdd	d a i g d c d d	2
fcgjj	f c g j j	2
jbhchjh	j b h c h j h	2
bdb	b d b	2
hccii	h c c i i	2
cdbci	c d b c i	2
dbbcec	d b b c e c	2
cdgijej	c d g i j e j	2
fdbcih	f d b c i h	2
eibbg	e i b b g	2
hfdjhi	h f d j h i	2
fcefcjj	f c e f c j j	2
gbahc	g b a h c	2
cjjfchc	c j j f c h c	2
jbicg	j b i c g	2
idhej	i d h e j	2
chdbccb	c h d b c c b	2
cgeagb	c g e a g b	2
dhabceh	d h a b c e h	2
chbeg	c h b e g	2
ebj	e b j	2
cbghi	c b g h i	2
chgcg	c h g c g	2
fhihif	f h i h i f	1
cjfj	c j f j	1
bcbiej	b c b i e j	1
eecc	e e c c	1
edidji	e d i d j i	1
fag	f a g	1
gciecc	g c i e c c	1
gabjaic	g a b j a i c	1
fjibc	f j i b c	1
ghh	g h h	1
cga	c g a	1
aahbj	a a h b j	1
bach	b a c h	1
hgie	h g i e	1
fhh	f h h	1
ibijc	i b i j c	1
gfjgfceg	g f j g f c e g	1
jaahfgch	j a a h f g c h	1
ijge	i j g e	1
dbifhi	d b i f h i	1
jedd	j e d d	1
ejbgcdaf	e j b g c d a f	1
cdeedia	c d e e d i a	1
dfggi	d f g g i	1
debcfjh	d e b c f j h	1
fccgji	f c c g j i	1
edcf	e d c f	1
dicii	d i c i i	1
dfbbjc	d f b b j c	1
bejgagi	b e j g a g i	1
jjdjgcg	j j d j g c g	1
gdadihcf	g d a d i h c f	1
gbg	g b g	1
gga	g g a	1
fjdi	f j d i	1
ghdcj	g h d c j	1
daic	d a i c	1
jcibdi	j c i b d i	1
cibic	c i b i c	1
ddjjj	d d j j j	1
jdieid	j d i e i d	1
adhgh	a d h g h	1
aebgbf	a e b g b f	1
jjhjbgc	j j h j b g c	1
figghci	f i g g h c i	1
bhec	b h e c	1
cdffific	c d f f i f i c	1
egdiei	e g d i e i	1
cdh	c d h	1
jcjhj	j c j h j	1
hiac	h i a c	1
hfbci	h f b c i	1
iijiicg	i i j i i c g	1
bgihcc	b g i h c c	1
adbac	a d b a c	1
eiadi	e i a d i	1
ghbe	g h b e	1
idejchc	i d e j c h c	1
dcejdj	d c e j d j	1
ehegc	e h e g c	1
eebh	e e b h	1
afbbac	a f b b a c	1
gdcddic	g d c d d i c	1
ieb	i e b	1
gcjgj	g c j g j	1
fdbfh	f d b f h	1
dec	d e c	1
djbbccj	d j b b c c j	1
ifa	i f a	1
gdeid	g d e i d	1
cdbebbae	c d b e b b a e	1
dfjjchcd	d f j j c h c d	1
jibiic	j i b i i c	1
hacc	h a c c	1
jbdec	j b d e c	1
bbhhjehg	b b h h j e h g	1
fbe	f b e	1
ghfgac	g h f g a c	1
ggjbj	g g j b j	1
hcgghea	h c g g h e a	1
daibih	d a i b i h	1
fbbeb	f b b e b	1
iahghee	i a h g h e e	1
hghaajfh	h g h a a j f h	1
dbhhj	d b h h j	1
eedc	e e d c	1
gejbh	g e j b h	1
geijbdcd	g e i j b d c d	1
edg	e d g	1
ghedg	g h e d g	1
biajg	b i a j g	1
ebgcc	e b g c c	1
hfhch	h f h c h	1
fbhafih	f b h a f i h	1
chch	c h c h	1
dcbc	d c b c	1
diadcjj	d i a d c j j	1
accfj	a c c f j	1
dddici	d d d i c i	1
bjfhhi	b j f h h i	1
fbcc	f b c c	1
igicbj	i g i c b j	1
jfdi	j f d i	1
bdjehgjg	b d j e h g j g	1
gdaijia	g d a i j i a	1
ebejbijh	e b e j b i j h	1
faeg	f a e g	1
ifhhbf	i f h h b f	1
dahh	d a h h	1
aaaj	a a a j	1
jah	j a h	1
hdc	h d c	1
jadgc	j a d g c	1
dbdbi	d b d b i	1
heagi	h e a g i	1
gbjii	g b j i i	1
gagi	g a g i	1
fchjhcac	f c h j h c a c	1
gghhifi	g g h h i f i	1
afc	a f c	1
cbjcbh	c b j c b h	1
hchh	h c h h	1
agb	a g b	1
gggcc	g g g c c	1
jfcidbi	j f c i d b i	1
jdchej	j d c h e j	1
bhegjhd	b h e g j h d	1
dfacbhbc	d f a c b h b c	1
feai	f e a i	1
djdi	d j d i	1
efd	e f d	1
ghcjida	g h c j i d a	1
ddac	d d a c	1
jfca	j f c a	1
jecgbddj	j e c g b d d j	1
aiijcj	a i i j c j	1
iabh	i a b h	1
bfdfhcii	b f d f h c i i	1
ghbj	g h b j	1
bbgejaj	b b g e j a j	1
bgihb	b g i h b	1
adcci	a d c c i	1
eaj	e a j	1
ahhdc	a h h d c	1
ahjjhh	a h j j h h	1
gbcddcei	g b c d d c e i	1
dabfich	d a b f i c h	1
fcdiic	f c d i i c	1
fbhgie	f b h g i e	1
ibbefb	i b b e f b	1
dgeci	d g e c i	1
gddhiih	g d d h i i h	1
hciicgi	h c i i c g i	1
ceg	c e g	1
hegcidhf	h e g c i d h f	1
bjechifh	b j e c h i f h	1
dfiigeh	d f i i g e h	1
fghbi	f g h b i	1
fccgc	f c c g c	1
hfa	h f a	1
cacfc	c a c f c	1
ichch	i c h c h	1
hcef	h c e f	1
bbac	b b a c	1
cbcec	c b c e c	1
hehchej	h e h c h e j	1
ejaddj	e j a d d j	1
igdh	i g d h	1
dbffh	d b f f h	1
egcbjf	e g c b j f	1
dbce	d b c e	1
cjcii	c j c i i	1
jcdh	j c d h	1
dgf	d g f	1
djiaca	d j i a c a	1
igdfcfh	i g d f c f h	1
cgc	c g c	1
ghjhiigh	g h j h i i g h	1
eec	e e c	1
abbgifda	a b b g i f d a	1
aea	a e a	1
ccbhj	c c b h j	1
iicag	i i c a g	1
ifcaj	i f c a j	1
fig	f i g	1
fhfcaef	f h f c a e f	1
aifji	a i f j i	1
dcdh	d c d h	1
fbeii	f b e i i	1
ibbfcbdc	i b b f c b d c	1
aeid	a e i d	1
adbi	a d b i	1
bagd	b a g d	1
dhhfgcj	d h h f g c j	1
cbcg	c b c g	1
fbbii	f b b i i	1
ecbhchc	e c b h c h c	1
dgfaehd	d g f a e h d	1
fecjiiif	f e c j i i i f	1
dbgcgb	d b g c g b	1
ecccj	e c c c j	1
dj	d j	1
ggcj	g g c j	1
aij	a i j	1
ffecic	f f e c i c	1
ihcg	i h c g	1
idfcicjc	i d f c i c j c	1
dbihc	d b i h c	1
ihfi	i h f i	1
jicfc	j i c f c	1
gighiig	g i g h i i g	1
ajbhab	a j b h a b	1
ghcihcc	g h c i h c c	1
bjii	b j i i	1
jia	j i a	1
iebci	i e b c i	1
adjbbc	a d j b b c	1
jfccj	j f c c j	1
eghbe	e g h b e	1
fdfcbfhg	f d f c b f h g	1
gfaci	g f a c i	1
ejiigf	e j i i g f	1
jgajbhfg	j g a j b h f g	1
fhcbii	f h c b i i	1
jjijjch	j j i j j c h	1
fbg	f b g	1
adcei	a d c e i	1
babdhch	b a b d h c h	1
gcdigghc	g c d i g g h c	1
cecdec	c e c d e c	1
ajbfejha	a j b f e j h a	1
gcghjbc	g c g h j b c	1
fcacgi	f c a c g i	1
afdji	a f d j i	1
gfcci	g f c c i	1
diijfc	d i i j f c	1
ehbc	e h b c	1
fcieicci	f c i e i c c i	1
cdigc	c d i g c	1
gbhcd	g b h c d	1
ijee	i j e e	1
cfaicb	c f a i c b	1
giacf	g i a c f	1
begjgbfb	b e g j g b f b	1
fbcjca	f b c j c a	1
cccid	c c c i d	1
heheffcb	h e h e f f c b	1
ghajc	g h a j c	1
fajc	f a j c	1
hifj	h i f j	1
adcfc	a d c f c	1
gijdi	g i j d i	1
diejeicf	d i e j e i c f	1
headhcdh	h e a d h c d h	1
fjhhcc	f j h h c c	1
jcch	j c c h	1
cihg	c i h g	1
ieiiac	i e i i a c	1
aiichhha	a i i c h h h a	1
dfjh	d f j h	1
daihjb	d a i h j b	1
ibiib	i b i i b	1
bjh	b j h	1
cedcehc	c e d c e h c	1
debda	d e b d a	1
dhidch	d h i d c h	1
bihic	b i h i c	1
cfadaah	c f a d a a h	1
bcecci	b c e c c i	1
bigi	b i g i	1
gii	g i i	1
fcj	f c j	1
dhchdi	d h c h d i	1
hdghj	h d g h j	1
bdgc	b d g c	1
ajh	a j h	1
cibce	c i b c e	1
ghghbci	g h g h b c i	1
dfjgbc	d f j g b c	1
ibfia	i b f i a	1
hfjfeh	h f j f e h	1
ebdahcic	e b d a h c i c	1
bjhf	b j h f	1
idei	i d e i	1
jbhbbfc	j b h b b f c	1
dhcbdgei	d h c b d g e i	1
dfgagcii	d f g a g c i i	1
jbgjc	j b g j c	1
cfabcij	c f a b c i j	1
idce	i d c e	1
cgdjfch	c g d j f c h	1
gfic	g f i c	1
jhcidja	j h c i d j a	1
adhdc	a d h d c	1
hiiahec	h i i a h e c	1
habcid	h a b c i d	1
cfgdj	c f g d j	1
ba	b a	1
agid	a g i d	1
gfcgf	g f c g f	1
iaae	i a a e	1
eeb	e e b	1
ajjc	a j j c	1
fcicc	f c i c c	1
ica	i c a	1
giehaji	g i e h a j i	1
eaffhei	e a f f h e i	1
gfbjj	g f b j j	1
ghhej	g h h e j	1
dbdi	d b d i	1
figfi	f i g f i	1
dheg	d h e g	1
dadcag	d a d c a g	1
fceicjh	f c e i c j h	1
gcghae	g c g h a e	1
egei	e g e i	1
fda	f d a	1
jijic	j i j i c	1
chfghci	c h f g h c i	1
jfjc	j f j c	1
gfjideb	g f j i d e b	1
ffiifc	f f i i f c	1
eecda	e e c d a	1
ahecid	a h e c i d	1
bdjjeihi	b d j j e i h i	1
gieh	g i e h	1
jibc	j i b c	1
jbajicfb	j b a j i c f b	1
jej	j e j	1
afdji	a f d j i	1
hcbhbi	h c b h b i	1
acdc	a c d c	1
ibedj	i b e d j	1
hei	h e i	1
gcje	g c j e	1
aejjfidh	a e j j f i d h	1
jcccc	j c c c c	1
gcic	g c i c	1
bjaeajc	b j a e a j c	1
bfbi	b f b i	1
efaeii	e f a e i i	1
cgfg	c g f g	1
ebhi	e b h i	1
eaicc	e a i c c	1
gged	g g e d	1
caabijjc	c a a b i j j c	1
aggecch	a g g e c c h	1
aadgf	a a d g f	1
feeeie	f e e e i e	1
ggccj	g g c c j	1
dfbic	d f b i c	1
adfcj	a d f c j	1
ajgci	a j g c i	1
dacgabe	d a c g a b e	1
eabaigj	e a b a i g j	1
cfgjbh	c f g j b h	1
bfcbcie	b f c b c i e	1
bacdi	b a c d i	1
efijcajj	e f i j c a j j	1
ghcceh	g h c c e h	1
egd	e g d	1
fegicc	f e g i c c	1
bihfj	b i h f j	1
dbgi	d b g i	1
ihdj	i h d j	1
chbbbc	c h b b b c	1
aaadhedj	a a a d h e d j	1
df	d f	1
cdd	c d d	1
agece	a g e c e	1
eeebfgj	e e e b f g j	1
iif	i i f	1
cehec	c e h e c	1
iaddhi	i a d d h i	1
hjebc	h j e b c	1
dgbfcihc	d g b f c i h c	1
cdfchbea	c d f c h b e a	1
ffbaehf	f f b a e h f	1
dfgdebih	d f g d e b i h	1
jiccjahd	j i c c j a h d	1
beh	b e h	1
jjjc	j j j c	1
bbhi	b b h i	1
adcg	a d c g	1
bhgabh	b h g a b h	1
dccjhai	d c c j h a i	1
eiaf	e i a f	1
cabc	c a b c	1
jfagh	j f a g h	1
dgdae	d g d a e	1
dech	d e c h	1
ajgjh	a j g j h	1
cghhbh	c g h h b h	1
gdgffdef	g d g f f d e f	1
jdjccid	j d j c c i d	1
cheeibj	c h e e i b j	1
iefiddci	i e f i d d c i	1
edfaibe	e d f a i b e	1
ghfjaei	g h f j a e i	1
hbhhi	h b h h i	1
aiabah	a i a b a h	1
gbaif	g b a i f	1
igahd	i g a h d	1
giich	g i i c h	1
ihef	i h e f	1
hefhbh	h e f h b h	1
cjjica	c j j i c a	1
fdifibjh	f d i f i b j h	1
bjdab	b j d a b	1
eaejiih	e a e j i i h	1
ihgbcii	i h g b c i i	1
cbfcf	c b f c f	1
ad	a d	1
difj	d i f j	1
efbihff	e f b i h f f	1
cbajc	c b a j c	1
cdhic	c d h i c	1
cbahgb	c b a h g b	1
chd	c h d	1
aiehce	a i e h c e	1
ijeiccch	i j e i c c c h	1
gdhh	g d h h	1
adhja	a d h j a	1
jehcidh	j e h c i d h	1
fhdahgd	f h d a h g d	1
abhf	a b h f	1
ijbeac	i j b e a c	1
eeaddib	e e a d d i b	1
jdhgjg	j d h g j g	1
fgf	f g f	1
agicc	a g i c c	1
aieii	a i e i i	1
diiijc	d i i i j c	1
ddij	d d i j	1
chiab	c h i a b	1
cjfffij	c j f f f i j	1
fb	f b	1
igb	i g b	1
bbdeeh	b b d e e h	1
gjbifgc	g j b i f g c	1
bajcecci	b a j c e c c i	1
cdafei	c d a f e i	1
baic	b a i c	1
aaciji	a a c i j i	1
cbbgghb	c b b g g h b	1
dfgac	d f g a c	1
habhic	h a b h i c	1
ggd	g g d	1
hgbbji	h g b b j i	1
egaj	e g a j	1
iehh	i e h h	1
chcd	c h c d	1
ijjc	i j j c	1
dbji	d b j i	1
ieh	i e h	1
hiahj	h i a h j	1
bcghc	b c g h c	1
gdfj	g d f j	1
fjicg	f j i c g	1
bidh	b i d h	1
icidiceh	i c i d i c e h	1
fhhgj	f h h g j	1
jihfc	j i h f c	1
dhhjhiia	d h h j h i i a	1
bfachj	b f a c h j	1
fihhjc	f i h h j c	1
fieddbc	f i e d d b c	1
cdcd	c d c d	1
dgc	d g c	1
iihh	i i h h	1
hbhdbff	h b h d b f f	1
acjjba	a c j j b a	1
gjgacc	g j g a c c	1
hgi	h g i	1
bdbbbefb	b d b b b e f b	1
dihd	d i h d	1
haeeich	h a e e i c h	1
gejegig	g e j e g i g	1
ggabi	g g a b i	1
faai	f a a i	1
cahid	c a h i d	1
fhd	f h d	1
dfecji	d f e c j i	1
gffbhghc	g f f b h g h c	1
eaa	e a a	1
fcci	f c c i	1
ddfc	d d f c	1
jhfdcfc	j h f d c f c	1
fgfi	f g f i	1
haf	h a f	1
fdjc	f d j c	1
gfedc	g f e d c	1
ahcgi	a h c g i	1
agcfaha	a g c f a h a	1
dhgccia	d h g c c i a	1
ccce	c c c e	1
hcfh	h c f h	1
deaccjej	d e a c c j e j	1
edb	e d b	1
cdcbh	c d c b h	1
jfh	j f h	1
afaj	a f a j	1
dhdiaf	d h d i a f	1
gghghfh	g g h g h f h	1
iejfgefb	i e j f g e f b	1
egi	e g i	1
aejfihia	a e j f i h i a	1
ddcj	d d c j	1
hcbfcgjj	h c b f c g j j	1
eaaeic	e a a e i c	1
fahche	f a h c h e	1
adgg	a d g g	1
diaici	d i a i c i	1
ifd	i f d	1
ahhehc	a h h e h c	1
jfhec	j f h e c	1
iagdad	i a g d a d	1
digahc	d i g a h c	1
iibg	i i b g	1
ifjcc	i f j c c	1
bhic	b h i c	1
fieihjc	f i e i h j c	1
gicja	g i c j a	1
bea	b e a	1
agc	a g c	1
ejfb	e j f b	1
ibhciii	i b h c i i i	1
jbic	j b i c	1
idbc	i d b c	1
aheb	a h e b	1
dahgc	d a h g c	1
ceacjh	c e a c j h	1
dhei	d h e i	1
fjdfijae	f j d f i j a e	1
bjd	b j d	1
bfhccjia	b f h c c j i a	1
fbghb	f b g h b	1
djdfiieh	d j d f i i e h	1
bae	b a e	1
dbcii	d b c i i	1
hhfbaijj	h h f b a i j j	1
eahiji	e a h i j i	1
jhfb	j h f b	1
cgjiahdi	c g j i a h d i	1
jjbijd	j j b i j d	1
egicbcd	e g i c b c d	1
cedga	c e d g a	1
edjccc	e d j c c c	1
fahha	f a h h a	1
fhf	f h f	1
jijcccc	j i j c c c c	1
hgjhi	h g j h i	1
dcih	d c i h	1
ghb	g h b	1
hhjfieg	h h j f i e g	1
ejfeihh	e j f e i h h	1
fibjce	f i b j c e	1
jhijcf	j h i j c f	1
ghgfbaa	g h g f b a a	1
aec	a e c	1
iadiii	i a d i i i	1
iahb	i a h b	1
jffghh	j f f g h h	1
icci	i c c i	1
addcc	a d d c c	1
fajaf	f a j a f	1
beb	b e b	1
fce	f c e	1
ggf	g g f	1
cibaaha	c i b a a h a	1
djgc	d j g c	1
dhaach	d h a a c h	1
ijjahiih	i j j a h i i h	1
ffbic	f f b i c	1
gdijghc	g d i j g h c	1
bbcbc	b b c b c	1
cdc	c d c	1
fbh	f b h	1
caace	c a a c e	1
cjceh	c j c e h	1
bhdb	b h d b	1
bha	b h a	1
agdfjaa	a g d f j a a	1
ihea	i h e a	1
jcjc	j c j c	1
bhecjgg	b h e c j g g	1
chjf	c h j f	1
djjcfif	d j j c f i f	1
hfhi	h f h i	1
hai	h a i	1
ibdeeabd	i b d e e a b d	1
bhgdcjij	b h g d c j i j	1
gfhcj	g f h c j	1
dfcci	d f c c i	1
fbjbfj	f b j b f j	1
ddjgfia	d d j g f i a	1
eia	e i a	1
djejj	d j e j j	1
ejjhdaac	e j j h d a a c	1
aiaahga	a i a a h g a	1
cgadeheh	c g a d e h e h	1
iiabeci	i i a b e c i	1
ghcdii	g h c d i i	1
gbc	g b c	1
gjicee	g j i c e e	1
ahbj	a h b j	1
fcagch	f c a g c h	1
gab	g a b	1
afibec	a f i b e c	1
jjf	j j f	1
bgdfcc	b g d f c c	1
fhjdgdd	f h j d g d d	1
dggahi	d g g a h i	1
