hehhci	h e h h c i	789
efhhfie	e f h h f i e	292
dag	d a g	239
fdh	f d h	223
jdhgcgc	j d h g c g c	213
idfeg	i d f e g	201
gafhcj	g a f h c j	96
hgig	h g i g	94
bfdgfcj	b f d g f c j	92
ajbfdg	a j b f d g	76
jjea	j j e a	76
icecech	i c e c e c h	66
jehjeecj	j e h j e e c j	53
bhh	b h h	46
fjhi	f j h i	46
jbbbdhjb	j b b b d h j b	36
agggjca	a g g g j c a	35
ghjafegf	g h j a f e g f	35
jffbeahi	j f f b e a h i	34
hdcb	h d c b	34
fcibcgij	f c i b c g i j	26
beihbjc	b e i h b j c	24
dddbjaf	d d d b j a f	23
hjfjdda	h j f j d d a	22
dhj	d h j	22
fhceceg	f h c e c e g	21
gaj	g a j	20
aid	a i d	19
hhf	h h f	18
bhbcb	b h b c b	18
bhea	b h e a	18
cciecaa	c c i e c a a	18
ejhghhcg	e j h g h h c g	17
ggfjfh	g g f j f h	17
ejfcda	e j f c d a	15
heda	h e d a	15
bfiidj	b f i i d j	14
fich	f i c h	13
fhcaejcg	f h c a e j c g	12
jghc	j g h c	12
gda	g d a	12
ccjcdbh	c c j c d b h	11
dcf	d c f	11
hdaifa	h d a i f a	11
ieegha	i e e g h a	11
icbh	i c b h	11
gehf	g e h f	11
gjdib	g j d i b	11
ebhfe	e b h f e	11
biagai	b i a g a i	10
fiihid	f i i h i d	10
igfffac	i g f f f a c	10
ieccaa	i e c c a a	10
eeggj	e e g g j	10
fddceej	f d d c e e j	10
acbbjd	a c b b j d	10
aacah	a a c a h	10
dib	d i b	10
gcgide	g c g i d e	9
dfee	d f e e	9
aejiic	a e j i i c	9
fieafh	f i e a f h	9
jacjcfc	j a c j c f c	9
ajbhcbj	a j b h c b j	9
ija	i j a	9
idic	i d i c	9
cdg	c d g	9
jiihhaeh	j i i h h a e h	9
hejhb	h e j h b	8
bgh	b g h	8
fbajdc	f b a j d c	8
hhbhgb	h h b h g b	8
dijdb	d i j d b	8
habfedgd	h a b f e d g d	8
eehghe	e e h g h e	8
ceadia	c e a d i a	8
jhdcghj	j h d c g h j	8
hge	h g e	8
jhhi	j h h i	8
dbedjc	d b e d j c	8
jcfbj	j c f b j	8
abhg	a b h g	7
fghbac	f g h b a c	7
ibffgfi	i b f f g f i	7
dbajgfea	d b a j g f e a	7
edgbd	e d g b d	7
bca	b c a	7
acgjjc	a c g j j c	7
bhg	b h g	7
cfih	c f i h	7
dgaae	d g a a e	7
afiegf	a f i e g f	7
gcdhide	g c d h i d e	7
efjbgbi	e f j b g b i	7
jdccaa	j d c c a a	7
hhchdb	h h c h d b	7
ciiie	c i i i e	6
ifbidg	i f b i d g	6
eiha	e i h a	6
acj	a c j	6
iefj	i e f j	6
ajgaec	a j g a e c	6
gbd	g b d	6
aheabfg	a h e a b f g	6
gfcj	g f c j	6
igceafh	i g c e a f h	6
bfidb	b f i d b	6
iage	i a g e	6
dhd	d h d	6
fbgih	f b g i h	6
ejc	e j c	6
bgfehag	b g f e h a g	6
jhfaeigh	j h f a e i g h	6
fhf	f h f	6
bfggibbg	b f g g i b b g	6
bgefebc	b g e f e b c	6
hchja	h c h j a	6
gagidcfe	g a g i d c f e	5
hjhddh	h j h d d h	5
feadih	f e a d i h	5
dcbfcc	d c b f c c	5
deifc	d e i f c	5
acif	a c i f	5
bcgf	b c g f	5
fhfaj	f h f a j	5
bgeda	b g e d a	5
giedcf	g i e d c f	5
bbgija	b b g i j a	5
cegiag	c e g i a g	5
jiida	j i i d a	5
fid	f i d	5
jgi	j g i	5
eiehhh	e i e h h h	5
hciijgg	h c i i j g g	5
heehgc	h e e h g c	5
jggg	j g g g	5
chc	c h c	5
hhiabje	h h i a b j e	4
jadhfhjc	j a d h f h j c	4
ggcjb	g g c j b	4
bcejdgjb	b c e j d g j b	4
jajga	j a j g a	4
cfai	c f a i	4
ehdi	e h d i	4
eeg	e e g	4
aebjdbbj	a e b j d b b j	4
bhhehg	b h h e h g	4
chgghiid	c h g g h i i d	4
ihebfgf	i h e b f g f	4
jjfac	j j f a c	4
beaggb	b e a g g b	4
ggjfcjj	g g j f c j j	4
ijhhcdd	i j h h c d d	4
gbjgeb	g b j g e b	4
ifbeicif	i f b e i c i f	4
gehjhdeh	g e h j h d e h	4
ifahgj	i f a h g j	4
cgbebc	c g b e b c	4
fcj	f c j	4
cjegia	c j e g i a	4
jaddbjc	j a d d b j c	4
jficgh	j f i c g h	4
hiebiccd	h i e b i c c d	4
jec	j e c	4
dhjidig	d h j i d i g	4
cgfcah	c g f c a h	4
jihj	j i h j	4
dec	d e c	4
bfafcg	b f a f c g	4
jjfcacj	j j f c a c j	4
fcjfagjf	f c j f a g j f	4
hdbca	h d b c a	4
cbc	c b c	4
bjea	b j e a	4
ffhic	f f h i c	4
fcfbi	f c f b i	4
ije	i j e	4
hdc	h d c	4
aaedb	a a e d b	3
iggfg	i g g f g	3
haidheeh	h a i d h e e h	3
chi	c h i	3
bgah	b g a h	3
bfgd	b f g d	3
ifa	i f a	3
diaabigj	d i a a b i g j	3
gdih	g d i h	3
iebcbif	i e b c b i f	3
hfbdbbac	h f b d b b a c	3
jjbj	j j b j	3
defaag	d e f a a g	3
bghbaa	b g h b a a	3
cbabdeh	c b a b d e h	3
gejfha	g e j f h a	3
habhiei	h a b h i e i	3
jecdc	j e c d c	3
ejij	e j i j	3
hced	h c e d	3
fchegh	f c h e g h	3
afhjdcci	a f h j d c c i	3
hcjbabi	h c j b a b i	3
cjg	c j g	3
ijje	i j j e	3
jjje	j j j e	3
dbahabdf	d b a h a b d f	3
cachfjjb	c a c h f j j b	3
jhiiiffb	j h i i i f f b	3
ajdec	a j d e c	3
dcbfha	d c b f h a	3
eaegg	e a e g g	3
ccbfced	c c b f c e d	3
dcihega	d c i h e g a	3
gjeidi	g j e i d i	3
jcigcd	j c i g c d	3
aieafe	a i e a f e	3
gchd	g c h d	3
hhcajafj	h h c a j a f j	3
dhdbh	d h d b h	3
iejda	i e j d a	3
gabcj	g a b c j	3
fhhifgc	f h h i f g c	3
ggcjjbi	g g c j j b i	3
ihdfa	i h d f a	3
bgc	b g c	3
cjiifh	c j i i f h	3
dcfbjhh	d c f b j h h	3
fad	f a d	3
gedgdi	g e d g d i	3
eidfchbg	e i d f c h b g	3
edgb	e d g b	3
dbeaefe	d b e a e f e	3
fjad	f j a d	3
cgf	c g f	3
gadf	g a d f	3
ejbb	e j b b	3
ggjjee	g g j j e e	3
befbeic	b e f b e i c	3
faheh	f a h e h	3
bgcjf	b g c j f	3
fbfef	f b f e f	3
igfc	i g f c	3
adgbb	a d g b b	3
dhadee	d h a d e e	3
dhh	d h h	3
dghg	d g h g	3
dddh	d d d h	3
dgfa	d g f a	3
hfgjg	h f g j g	3
hjhih	h j h i h	3
adjagd	a d j a g d	3
fdjf	f d j f	3
hja	h j a	2
fdjfcaja	f d j f c a j a	2
heachdf	h e a c h d f	2
jbbghcj	j b b g h c j	2
ghij	g h i j	2
dddccdib	d d d c c d i b	2
cha	c h a	2
bhb	b h b	2
jijfcei	j i j f c e i	2
hjabfeji	h j a b f e j i	2
gfa	g f a	2
ceejc	c e e j c	2
ebf	e b f	2
iajfd	i a j f d	2
chf	c h f	2
gbjf	g b j f	2
ffcfifc	f f c f i f c	2
ifc	i f c	2
geeaga	g e e a g a	2
iac	i a c	2
bhfcfiec	b h f c f i e c	2
eeeicf	e e e i c f	2
jjahj	j j a h j	2
adici	a d i c i	2
ccfhdf	c c f h d f	2
gahidbj	g a h i d b j	2
hgjacch	h g j a c c h	2
bcggjcej	b c g g j c e j	2
bab	b a b	2
hchjje	h c h j j e	2
fgehfihe	f g e h f i h e	2
chh	c h h	2
chajcgbg	c h a j c g b g	2
idej	i d e j	2
cjjcddff	c j j c d d f f	2
aeiabhci	a e i a b h c i	2
ahceji	a h c e j i	2
eeib	e e i b	2
jdj	j d j	2
gibhi	g i b h i	2
hgb	h g b	2
hebidaji	h e b i d a j i	2
gdebdc	g d e b d c	2
dbhjgeeg	d b h j g e e g	2
aedicec	a e d i c e c	2
jifedi	j i f e d i	2
jgaagc	j g a a g c	2
gchecga	g c h e c g a	2
hjhjh	h j h j h	2
hajcdggc	h a j c d g g c	2
jigc	j i g c	2
bbhdfb	b b h d f b	2
hfbbfab	h f b b f a b	2
djg	d j g	2
ggdbdfb	g g d b d f b	2
jbihbiij	j b i h b i i j	2
haje	h a j e	2
ieh	i e h	2
ihgfi	i h g f i	2
dgddii	d g d d i i	2
bee	b e e	2
efjhbcdj	e f j h b c d j	2
fgg	f g g	2
djf	d j f	2
hee	h e e	2
iabaffj	i a b a f f j	2
hgbcddia	h g b c d d i a	2
cecc	c e c c	2
fgfgibh	f g f g i b h	2
achgj	a c h g j	2
igc	i g c	2
hhcb	h h c b	2
ief	i e f	2
cheid	c h e i d	2
jdbggd	j d b g g d	2
hfideb	h f i d e b	2
gijfdgdb	g i j f d g d b	2
djefdi	d j e f d i	2
abcai	a b c a i	2
jid	j i d	2
jefdeih	j e f d e i h	2
icb	i c b	2
bgb	b g b	2
fifj	f i f j	2
gcaade	g c a a d e	2
fehebgej	f e h e b g e j	2
ghdjfcd	g h d j f c d	2
hcbadh	h c b a d h	2
iijbai	i i j b a i	2
bib	b i b	2
hfdeef	h f d e e f	2
ebie	e b i e	2
fhhaaii	f h h a a i i	2
hejdfec	h e j d f e c	2
bhabidef	b h a b i d e f	2
bdiib	b d i i b	2
jfed	j f e d	2
ceehgbda	c e e h g b d a	2
iciejdc	i c i e j d c	2
ghd	g h d	2
def	d e f	2
cijjgci	c i j j g c i	2
ibg	i b g	2
fchgjh	f c h g j h	2
acf	a c f	2
ddejgggf	d d e j g g g f	2
dhhcc	d h h c c	2
fcbbhbf	f c b b h b f	2
cheaj	c h e a j	2
ddhij	d d h i j	2
ggaeid	g g a e i d	2
eabahcfb	e a b a h c f b	2
bgjb	b g j b	2
fhbdd	f h b d d	2
jehajdf	j e h a j d f	2
gdi	g d i	2
hjiif	h j i i f	2
jefijgbe	j e f i j g b e	2
ahgc	a h g c	2
efgahf	e f g a h f	2
eiii	e i i i	2
ejecjf	e j e c j f	2
bhgjjdgd	b h g j j d g d	2
dhia	d h i a	2
gbe	g b e	2
jcj	j c j	2
dgbdfiee	d g b d f i e e	2
feh	f e h	2
ffceeidd	f f c e e i d d	2
hgadf	h g a d f	2
dfhe	d f h e	2
ccgghjeg	c c g g h j e g	2
jebecjcb	j e b e c j c b	2
agghch	a g g h c h	2
fdhbcfga	f d h b c f g a	2
ifjj	i f j j	2
fadabj	f a d a b j	1
fjhbd	f j h b d	1
ficj	f i c j	1
cbiggafe	c b i g g a f e	1
jjehccac	j j e h c c a c	1
djaja	d j a j a	1
facjfcfg	f a c j f c f g	1
dfeiifg	d f e i i f g	1
jbdg	j b d g	1
gjcgeeih	g j c g e e i h	1
facchbch	f a c c h b c h	1
fghijaa	f g h i j a a	1
jef	j e f	1
acfe	a c f e	1
didhjigf	d i d h j i g f	1
hehdiefi	h e h d i e f i	1
biejcfdd	b i e j c f d d	1
giagg	g i a g g	1
eggejdf	e g g e j d f	1
fdi	f d i	1
jebdf	j e b d f	1
jgaicf	j g a i c f	1
afb	a f b	1
hijihcd	h i j i h c d	1
accafbi	a c c a f b i	1
fjihcgi	f j i h c g i	1
idc	i d c	1
ffdcf	f f d c f	1
aahdff	a a h d f f	1
fgdhb	f g d h b	1
cdjig	c d j i g	1
bcaggide	b c a g g i d e	1
dejdi	d e j d i	1
iiajdge	i i a j d g e	1
hhebf	h h e b f	1
icifiacg	i c i f i a c g	1
ggbff	g g b f f	1
dafc	d a f c	1
adcfjf	a d c f j f	1
dachbb	d a c h b b	1
dehb	d e h b	1
ddbidicj	d d b i d i c j	1
gdagaa	g d a g a a	1
diaef	d i a e f	1
ghabg	g h a b g	1
gieajdg	g i e a j d g	1
fcb	f c b	1
efb	e f b	1
iccidb	i c c i d b	1
ghigcbj	g h i g c b j	1
jadhidj	j a d h i d j	1
dgcac	d g c a c	1
dgcafjdg	d g c a f j d g	1
jgfjjaji	j g f j j a j i	1
cji	c j i	1
ggfbad	g g f b a d	1
cebief	c e b i e f	1
gjeeega	g j e e e g a	1
gfbdcd	g f b d c d	1
dcehcdea	d c e h c d e a	1
bjafg	b j a f g	1
ehe	e h e	1
egj	e g j	1
hfib	h f i b	1
jedci	j e d c i	1
jcheij	j c h e i j	1
hci	h c i	1
aeddgcd	a e d d g c d	1
ccfihj	c c f i h j	1
jhbf	j h b f	1
hii	h i i	1
fjgaci	f j g a c i	1
gbbbh	g b b b h	1
dgiiccb	d g i i c c b	1
dejjeaid	d e j j e a i d	1
eje	e j e	1
geee	g e e e	1
icc	i c c	1
ghefj	g h e f j	1
abeb	a b e b	1
gdgfjde	g d g f j d e	1
chcaafca	c h c a a f c a	1
idi	i d i	1
dbd	d b d	1
cehj	c e h j	1
bhbjf	b h b j f	1
bhc	b h c	1
edfdgia	e d f d g i a	1
badia	b a d i a	1
hfcfeb	h f c f e b	1
jaebf	j a e b f	1
jdd	j d d	1
faa	f a a	1
gdgcgbfd	g d g c g b f d	1
gcf	g c f	1
ggdbib	g g d b i b	1
aeehfdj	a e e h f d j	1
jcbg	j c b g	1
hhe	h h e	1
dedahfi	d e d a h f i	1
ddggiggf	d d g g i g g f	1
gegfah	g e g f a h	1
eabdjiji	e a b d j i j i	1
aicjejj	a i c j e j j	1
jiic	j i i c	1
eajb	e a j b	1
jci	j c i	1
jjb	j j b	1
afceejh	a f c e e j h	1
gijdfgb	g i j d f g b	1
abif	a b i f	1
jheggc	j h e g g c	1
fcefi	f c e f i	1
dccfd	d c c f d	1
cidi	c i d i	1
haai	h a a i	1
fiabhjc	f i a b h j c	1
jebid	j e b i d	1
deii	d e i i	1
fcga	f c g a	1
addbcaa	a d d b c a a	1
febf	f e b f	1
ffbfgfib	f f b f g f i b	1
fdia	f d i a	1
aicfjdf	a i c f j d f	1
ccgg	c c g g	1
bdig	b d i g	1
dia	d i a	1
ihgdf	i h g d f	1
eddhc	e d d h c	1
gfiiicgb	g f i i i c g b	1
ccfdbe	c c f d b e	1
cdbicgfi	c d b i c g f i	1
ibcahgd	i b c a h g d	1
fabaeghi	f a b a e g h i	1
jdddi	j d d d i	1
jdjc	j d j c	1
jjddfdch	j j d d f d c h	1
afbb	a f b b	1
ajf	a j f	1
dbgh	d b g h	1
agccbj	a g c c b j	1
abbchd	a b b c h d	1
efaj	e f a j	1
adefhi	a d e f h i	1
eiib	e i i b	1
dahgai	d a h g a i	1
ebh	e b h	1
hghgbieb	h g h g b i e b	1
jgejcfia	j g e j c f i a	1
dhaad	d h a a d	1
dcdd	d c d d	1
achb	a c h b	1
bgedgdhe	b g e d g d h e	1
eajbf	e a j b f	1
jiifijd	j i i f i j d	1
gedbga	g e d b g a	1
dbc	d b c	1
edifajac	e d i f a j a c	1
bdhcjihg	b d h c j i h g	1
jdh	j d h	1
fifeagg	f i f e a g g	1
haiab	h a i a b	1
fjh	f j h	1
bedhaie	b e d h a i e	1
aah	a a h	1
ecged	e c g e d	1
chejghf	c h e j g h f	1
bjhbah	b j h b a h	1
ajeij	a j e i j	1
hcfbcb	h c f b c b	1
aebif	a e b i f	1
jidihaig	j i d i h a i g	1
fjjfbcb	f j j f b c b	1
afig	a f i g	1
fba	f b a	1
ieceg	i e c e g	1
fegag	f e g a g	1
bdibcc	b d i b c c	1
daijhbh	d a i j h b h	1
acacaafb	a c a c a a f b	1
hbiajde	h b i a j d e	1
cajghii	c a j g h i i	1
bgdjd	b g d j d	1
jeagab	j e a g a b	1
cgdh	c g d h	1
hgd	h g d	1
eeafegc	e e a f e g c	1
ihj	i h j	1
ebceaeba	e b c e a e b a	1
hdhb	h d h b	1
iccaad	i c c a a d	1
jchjg	j c h j g	1
igdcbbda	i g d c b b d a	1
idiaghda	i d i a g h d a	1
ejh	e j h	1
ifj	i f j	1
chbcbeba	c h b c b e b a	1
ddie	d d i e	1
jidgghfb	j i d g g h f b	1
hagab	h a g a b	1
fcbe	f c b e	1
idegiec	i d e g i e c	1
aiad	a i a d	1
fddfbjcb	f d d f b j c b	1
cfijhafg	c f i j h a f g	1
fhdjbgge	f h d j b g g e	1
bdi	b d i	1
iccicai	i c c i c a i	1
iejdidga	i e j d i d g a	1
bgjfeg	b g j f e g	1
gfd	g f d	1
dgcbddc	d g c b d d c	1
dhdb	d h d b	1
abjgccfg	a b j g c c f g	1
dchijiei	d c h i j i e i	1
ihc	i h c	1
adhfbi	a d h f b i	1
edchde	e d c h d e	1
fajhdcf	f a j h d c f	1
difjfbjb	d i f j f b j b	1
jjgicjc	j j g i c j c	1
gfajhde	g f a j h d e	1
gce	g c e	1
ajhhfh	a j h h f h	1
bhhcce	b h h c c e	1
jcg	j c g	1
cga	c g a	1
fgee	f g e e	1
ijj	i j j	1
aej	a e j	1
gbjhfbdb	g b j h f b d b	1
iaij	i a i j	1
haabaci	h a a b a c i	1
gghab	g g h a b	1
gdceg	g d c e g	1
gacdfi	g a c d f i	1
heeicgcj	h e e i c g c j	1
abhfj	a b h f j	1
gfbgghdd	g f b g g h d d	1
bji	b j i	1
fjeebfi	f j e e b f i	1
cgjbjh	c g j b j h	1
fdebehe	f d e b e h e	1
jcc	j c c	1
iefja	i e f j a	1
jcbfigf	j c b f i g f	1
gcaac	g c a a c	1
fabdce	f a b d c e	1
iifb	i i f b	1
habghbbc	h a b g h b b c	1
bfdafj	b f d a f j	1
jfaha	j f a h a	1
bbhf	b b h f	1
fhdi	f h d i	1
jbabdhe	j b a b d h e	1
hjce	h j c e	1
iib	i i b	1
ccd	c c d	1
djcbh	d j c b h	1
jhhcdh	j h h c d h	1
cagg	c a g g	1
ebhd	e b h d	1
iehgidid	i e h g i d i d	1
jahhd	j a h h d	1
bgfbdigd	b g f b d i g d	1
gajfajbh	g a j f a j b h	1
hfehicc	h f e h i c c	1
aeahdg	a e a h d g	1
bifh	b i f h	1
ebcbbeff	e b c b b e f f	1
baaedeg	b a a e d e g	1
fddae	f d d a e	1
fggai	f g g a i	1
ejaejhe	e j a e j h e	1
ciffdij	c i f f d i j	1
efaee	e f a e e	1
acg	a c g	1
hceeca	h c e e c a	1
gjefijb	g j e f i j b	1
afh	a f h	1
dddg	d d d g	1
aeddie	a e d d i e	1
highdh	h i g h d h	1
ccfj	c c f j	1
jdb	j d b	1
cfgiifgh	c f g i i f g h	1
gcac	g c a c	1
aja	a j a	1
gajbgic	g a j b g i c	1
jjbccebj	j j b c c e b j	1
begchj	b e g c h j	1
ceed	c e e d	1
gbjajb	g b j a j b	1
cebhcc	c e b h c c	1
jdfifidb	j d f i f i d b	1
ejjadded	e j j a d d e d	1
gdecdih	g d e c d i h	1
ccj	c c j	1
cibabh	c i b a b h	1
ejcjgg	e j c j g g	1
gbabd	g b a b d	1
ehejcg	e h e j c g	1
ifijcfbi	i f i j c f b i	1
eji	e j i	1
efjddh	e f j d d h	1
habhbj	h a b h b j	1
jjcigjcc	j j c i g j c c	1
fff	f f f	1
cfe	c f e	1
aiddf	a i d d f	1
eca	e c a	1
hdihbji	h d i h b j i	1
deah	d e a h	1
jihcbhee	j i h c b h e e	1
hjbahgci	h j b a h g c i	1
hif	h i f	1
fjjea	f j j e a	1
haib	h a i b	1
gahci	g a h c i	1
eijd	e i j d	1
biadg	b i a d g	1
ihec	i h e c	1
djh	d j h	1
ggcjdjij	g g c j d j i j	1
aajcfcai	a a j c f c a i	1
efdigd	e f d i g d	1
big	b i g	1
hah	h a h	1
ecf	e c f	1
efigbifh	e f i g b i f h	1
icghh	i c g h h	1
gedh	g e d h	1
jjicbdf	j j i c b d f	1
aig	a i g	1
ehf	e h f	1
ihbgga	i h b g g a	1
fgjeiff	f g j e i f f	1
ddcegcig	d d c e g c i g	1
higggjh	h i g g g j h	1
gcdd	g c d d	1
ehgbdgea	e h g b d g e a	1
cea	c e a	1
idccej	i d c c e j	1
cfa	c f a	1
cihhca	c i h h c a	1
ibbfjgfg	i b b f j g f g	1
ifhjei	i f h j e i	1
ejcfae	e j c f a e	1
cjfgh	c j f g h	1
hfhibc	h f h i b c	1
gbca	g b c a	1
dhjfbje	d h j f b j e	1
hcedahgb	h c e d a h g b	1
gba	g b a	1
hbda	h b d a	1
agfd	a g f d	1
djah	d j a h	1
ehh	e h h	1
hfdfda	h f d f d a	1
cjehc	c j e h c	1
dge	d g e	1
ddibcb	d d i b c b	1
gjjccj	g j j c c j	1
igfb	i g f b	1
ecibje	e c i b j e	1
jgbd	j g b d	1
fffc	f f f c	1
cacgdejf	c a c g d e j f	1
gjjj	g j j j	1
fieifcdi	f i e i f c d i	1
eciihfij	e c i i h f i j	1
cbjf	c b j f	1
bheffb	b h e f f b	1
dcjbbdgd	d c j b b d g d	1
ghf	g h f	1
gefjcfci	g e f j c f c i	1
ebbe	e b b e	1
ccchi	c c c h i	1
hgic	h g i c	1
aicfajj	a i c f a j j	1
jfdahjf	j f d a h j f	1
bgigihei	b g i g i h e i	1
cijhaa	c i j h a a	1
iidgah	i i d g a h	1
fdjh	f d j h	1
eigja	e i g j a	1
eehe	e e h e	1
hiaaficj	h i a a f i c j	1
ggh	g g h	1
icbidie	i c b i d i e	1
dgcfd	d g c f d	1
gccjbifd	g c c j b i f d	1
ebcffgb	e b c f f g b	1
dcihhb	d c i h h b	1
cbeebf	c b e e b f	1
cjhabebf	c j h a b e b f	1
cif	c i f	1
gbaa	g b a a	1
gabfa	g a b f a	1
hacdgic	h a c d g i c	1
bjigg	b j i g g	1
ebgc	e b g c	1
fhbjd	f h b j d	1
gbg	g b g	1
eafjiac	e a f j i a c	1
ibbcfi	i b b c f i	1
ijeeajea	i j e e a j e a	1
aadb	a a d b	1
abfcgf	a b f c g f	1
idhdaj	i d h d a j	1
gcacdac	g c a c d a c	1
gced	g c e d	1
dfch	d f c h	1
cfgid	c f g i d	1
hadjg	h a d j g	1
cgfda	c g f d a	1
bageeh	b a g e e h	1
acei	a c e i	1
dcacehic	d c a c e h i c	1
idbee	i d b e e	1
ajbfaa	a j b f a a	1
jcehb	j c e h b	1
jbi	j b i	1
dhicf	d h i c f	1
ded	d e d	1
che	c h e	1
adcjf	a d c j f	1
jcbei	j c b e i	1
feje	f e j e	1
becedii	b e c e d i i	1
gagbe	g a g b e	1
adjfdi	a d j f d i	1
agigfj	a g i g f j	1
hbfdha	h b f d h a	1
beg	b e g	1
gecab	g e c a b	1
ifjgbga	i f j g b g a	1
hcbaeed	h c b a e e d	1
ejed	e j e d	1
gcaidch	g c a i d c h	1
jjeh	j j e h	1
ghiidc	g h i i d c	1
ccagiaid	c c a g i a i d	1
adgg	a d g g	1
fgfdacbb	f g f d a c b b	1
dbjiiagd	d b j i i a g d	1
didcbjgf	d i d c b j g f	1
hjfd	h j f d	1
eehfb	e e h f b	1
hieeji	h i e e j i	1
hhbcbgjj	h h b c b g j j	1
jgeaafh	j g e a a f h	1
giabdgff	g i a b d g f f	1
jjgff	j j g f f	1
bieddf	b i e d d f	1
dafbiie	d a f b i i e	1
ddbbfg	d d b b f g	1
iaab	i a a b	1
fach	f a c h	1
ggf	g g f	1
feb	f e b	1
bhcecjd	b h c e c j d	1
beeh	b e e h	1
ejfci	e j f c i	1
hfej	h f e j	1
hhgf	h h g f	1
bcaigih	b c a i g i h	1
hedb	h e d b	1
eeagfhbd	e e a g f h b d	1
ijfjaba	i j f j a b a	1
hjgfabdc	h j g f a b d c	1
fef	f e f	1
jejefc	j e j e f c	1
faecdfhd	f a e c d f h d	1
bffb	b f f b	1
fhjgbd	f h j g b d	1
gad	g a d	1
biciae	b i c i a e	1
egeie	e g e i e	1
ecehgi	e c e h g i	1
dfffbef	d f f f b e f	1
jdfi	j d f i	1
eaafhh	e a a f h h	1
adehbhe	a d e h b h e	1
ggc	g g c	1
dggdi	d g g d i	1
fdiicjba	f d i i c j b a	1
bdahjhib	b d a h j h i b	1
cjja	c j j a	1
jhcghefh	j h c g h e f h	1
chajha	c h a j h a	1
bdd	b d d	1
aicifd	a i c i f d	1
ghjihh	g h j i h h	1
jgfa	j g f a	1
jaeaa	j a e a a	1
dah	d a h	1
gbfa	g b f a	1
eiijidfd	e i i j i d f d	1
cceegga	c c e e g g a	1
bgjjd	b g j j d	1
eahgadd	e a h g a d d	1
jgdf	j g d f	1
edfci	e d f c i	1
geegg	g e e g g	1
bgj	b g j	1
dhchfg	d h c h f g	1
fae	f a e	1
cebij	c e b i j	1
caigea	c a i g e a	1
hhjbhaj	h h j b h a j	1
agi	a g i	1
eadfeg	e a d f e g	1
gghdd	g g h d d	1
ijfgbj	i j f g b j	1
ahhigjbf	a h h i g j b f	1
cdj	c d j	1
hjjdaice	h j j d a i c e	1
jihbbja	j i h b b j a	1
idecfca	i d e c f c a	1
fecjig	f e c j i g	1
icccfce	i c c c f c e	1
ajcjjj	a j c j j j	1
hjffcia	h j f f c i a	1
jfheag	j f h e a g	1
gachbbbi	g a c h b b b i	1
gbbicd	g b b i c d	1
hcg	h c g	1
cdedcb	c d e d c b	1
biibdae	b i i b d a e	1
hgac	h g a c	1
geehh	g e e h h	1
bidjadad	b i d j a d a d	1
gfg	g f g	1
jgiabic	j g i a b i c	1
idiiccaf	i d i i c c a f	1
cdchi	c d c h i	1
bcaha	b c a h a	1
aaig	a a i g	1
faaaf	f a a a f	1
ejbi	e j b i	1
fci	f c i	1
ecea	e c e a	1
chci	c h c i	1
dhghbb	d h g h b b	1
hjh	h j h	1
dic	d i c	1
dga	d g a	1
becdbdf	b e c d b d f	1
jefbc	j e f b c	1
gchaecab	g c h a e c a b	1
jbaegfd	j b a e g f d	1
dcjhacdb	d c j h a c d b	1
egfbided	e g f b i d e d	1
jjaegg	j j a e g g	1
dihci	d i h c i	1
ebdf	e b d f	1
dghbf	d g h b f	1
gbgh	g b g h	1
ecabaj	e c a b a j	1
fgi	f g i	1
jgdgibb	j g d g i b b	1
jjbbcjhg	j j b b c j h g	1
dfdfgg	d f d f g g	1
iaeface	i a e f a c e	1
dehgcjc	d e h g c j c	1
jfb	j f b	1
caif	c a i f	1
dcc	d c c	1
gii	g i i	1
habab	h a b a b	1
fffee	f f f e e	1
dggaddfj	d g g a d d f j	1
ecfbdc	e c f b d c	1
bbccg	b b c c g	1
cdhe	c d h e	1
edjh	e d j h	1
cfi	c f i	1
ahife	a h i f e	1
bhgj	b h g j	1
cefdgdf	c e f d g d f	1
ieacc	i e a c c	1
agjebbdh	a g j e b b d h	1
cgjfig	c g j f i g	1
debd	d e b d	1
adfgfbi	a d f g f b i	1
ijdca	i j d c a	1
dbdaaebi	d b d a a e b i	1
hbeiifi	h b e i i f i	1
dbdeaeba	d b d e a e b a	1
cid	c i d	1
jigacfeh	j i g a c f e h	1
acii	a c i i	1
aijfbgg	a i j f b g g	1
jihbe	j i h b e	1
jiccc	j i c c c	1
bbhd	b b h d	1
gjefgag	g j e f g a g	1
jafa	j a f a	1
eehdjaj	e e h d j a j	1
jfh	j f h	1
cii	c i i	1
cfcd	c f c d	1
hdcih	h d c i h	1
eehcd	e e h c d	1
eccfb	e c c f b	1
ejfa	e j f a	1
bdhgbeai	b d h g b e a i	1
ifh	i f h	1
aiejbf	a i e j b f	1
ibhab	i b h a b	1
hfb	h f b	1
