e	e	1791
ffi	f f i	1275
c	c	780
fjafh	f j a f h	254
fcagf	f c a g f	220
d	d	189
gh	g h	183
jg	j g	75
b	b	71
ic	i c	68
dg	d g	67
ahc	a h c	56
h	h	55
hhf	h h f	55
aihi	a i h i	53
jh	j h	37
hic	h i c	35
gdi	g d i	35
ihi	i h i	33
bi	b i	28
ga	g a	26
ggf	g g f	25
aj	a j	25
ji	j i	25
gjii	g j i i	25
da	d a	24
ifb	i f b	23
ih	i h	23
id	i d	22
ia	i a	22
bfi	b f i	22
gj	g j	22
bg	b g	22
gb	g b	21
if	i f	20
gag	g a g	20
ggi	g g i	19
dac	d a c	19
ejh	e j h	19
igh	i g h	18
dd	d d	17
je	j e	17
adc	a d c	17
hci	h c i	17
dfci	d f c i	16
g	g	16
fe	f e	15
hhaj	h h a j	15
gggc	g g g c	15
igi	i g i	15
cif	c i f	15
efi	e f i	14
bf	b f	14
jb	j b	14
gd	g d	14
ajj	a j j	13
ggb	g g b	13
ci	c i	13
fhfh	f h f h	13
ig	i g	12
ege	e g e	12
aij	a i j	12
ibi	i b i	11
gjj	g j j	11
gi	g i	11
ggba	g g b a	11
fjii	f j i i	11
gif	g i f	11
jd	j d	10
ggd	g g d	10
iif	i i f	10
aa	a a	10
cj	c j	10
iag	i a g	9
ib	i b	9
giifa	g i i f a	9
ihd	i h d	9
icbf	i c b f	9
hde	h d e	9
ihgh	i h g h	8
jcdfhb	j c d f h b	8
haf	h a f	8
cfehc	c f e h c	8
fci	f c i	8
deh	d e h	8
cad	c a d	8
djc	d j c	7
jci	j c i	7
jgcia	j g c i a	7
eh	e h	7
gci	g c i	7
egf	e g f	7
jcd	j c d	7
jaa	j a a	7
ehii	e h i i	7
bahh	b a h h	7
fbjc	f b j c	6
aajc	a a j c	6
ich	i c h	6
aje	a j e	6
ffjgi	f f j g i	6
hif	h i f	6
hbig	h b i g	6
jfgf	j f g f	6
jjihei	j j i h e i	6
cef	c e f	6
cgffh	c g f f h	6
chi	c h i	6
iii	i i i	6
acbg	a c b g	5
dhf	d h f	5
ciiij	c i i i j	5
ibh	i b h	5
hhb	h h b	5
ahac	a h a c	5
daf	d a f	5
bjjfif	b j j f i f	5
bjhii	b j h i i	5
ife	i f e	5
ehif	e h i f	5
bfc	b f c	5
ahde	a h d e	5
ibch	i b c h	5
bbh	b b h	5
ab	a b	5
jfi	j f i	5
bjbi	b j b i	5
cagag	c a g a g	5
jjcf	j j c f	4
beiic	b e i i c	4
jbia	j b i a	4
jbfahi	j b f a h i	4
bbjfh	b b j f h	4
jeif	j e i f	4
jii	j i i	4
ejah	e j a h	4
hgige	h g i g e	4
fiiii	f i i i i	4
hiih	h i i h	4
iihchhc	i i h c h h c	4
bia	b i a	4
icde	i c d e	4
ehb	e h b	4
jch	j c h	4
jhih	j h i h	4
cadf	c a d f	4
ebhi	e b h i	4
jj	j j	4
hag	h a g	4
gchb	g c h b	4
cg	c g	4
ijg	i j g	4
agfii	a g f i i	4
dfihi	d f i h i	4
bdaf	b d a f	4
j	j	4
aih	a i h	4
jaj	j a j	4
hgg	h g g	4
dbef	d b e f	4
ehdc	e h d c	4
jffc	j f f c	4
ifdcg	i f d c g	4
fai	f a i	4
idii	i d i i	3
dbb	d b b	3
aji	a j i	3
ieia	i e i a	3
jjhii	j j h i i	3
bjb	b j b	3
eif	e i f	3
aecd	a e c d	3
ie	i e	3
bhhfh	b h h f h	3
gbci	g b c i	3
ebc	e b c	3
baghi	b a g h i	3
jcagihc	j c a g i h c	3
jbcf	j b c f	3
ceaijc	c e a i j c	3
ggh	g g h	3
ahfa	a h f a	3
dhife	d h i f e	3
afig	a f i g	3
eid	e i d	3
gga	g g a	3
dib	d i b	3
gijc	g i j c	3
idigci	i d i g c i	3
a	a	3
hih	h i h	3
gidfj	g i d f j	3
fjgj	f j g j	3
bifcf	b i f c f	3
jehi	j e h i	3
ehehc	e h e h c	3
ciff	c i f f	3
afhh	a f h h	3
ccgii	c c g i i	3
igf	i g f	3
iagfic	i a g f i c	3
jfchf	j f c h f	3
dhfii	d h f i i	3
hagc	h a g c	3
gefhfh	g e f h f h	3
diiif	d i i i f	3
igfi	i g f i	3
jid	j i d	3
adjff	a d j f f	3
ffjchhaf	f f j c h h a f	2
giibi	g i i b i	2
bifcg	b i f c g	2
hbhaihi	h b h a i h i	2
igih	i g i h	2
ficib	f i c i b	2
jdegbi	j d e g b i	2
fie	f i e	2
addi	a d d i	2
abia	a b i a	2
ejfi	e j f i	2
fceii	f c e i i	2
cfiaf	c f i a f	2
gge	g g e	2
dddi	d d d i	2
ebchgh	e b c h g h	2
iieie	i i e i e	2
jfadhh	j f a d h h	2
jjhf	j j h f	2
eeih	e e i h	2
fgcb	f g c b	2
adgffi	a d g f f i	2
djfj	d j f j	2
ibbh	i b b h	2
jich	j i c h	2
eaahh	e a a h h	2
acgffh	a c g f f h	2
gcffeih	g c f f e i h	2
abg	a b g	2
fgeffi	f g e f f i	2
abjc	a b j c	2
icgchie	i c g c h i e	2
ciaiigc	c i a i i g c	2
bijfhgb	b i j f h g b	2
jiaic	j i a i c	2
ggfgih	g g f g i h	2
fcicfc	f c i c f c	2
jfa	j f a	2
iihdh	i i h d h	2
dbiah	d b i a h	2
gjaa	g j a a	2
iahh	i a h h	2
efghcf	e f g h c f	2
ibjii	i b j i i	2
dehjfbi	d e h j f b i	2
ajfie	a j f i e	2
iaaaiah	i a a a i a h	2
hcjheaah	h c j h e a a h	2
adijac	a d i j a c	2
fic	f i c	2
daijaf	d a i j a f	2
bdibi	b d i b i	2
efaighh	e f a i g h h	2
hghhhb	h g h h h b	2
fggf	f g g f	2
aeaih	a e a i h	2
bgiif	b g i i f	2
afgiaj	a f g i a j	2
iiaai	i i a a i	2
egcg	e g c g	2
fagh	f a g h	2
bjhi	b j h i	2
aaii	a a i i	2
bfgg	b f g g	2
bdhiiia	b d h i i i a	2
iib	i i b	2
ejhbc	e j h b c	2
aff	a f f	2
bahhi	b a h h i	2
gefi	g e f i	2
cadhie	c a d h i e	2
jgfc	j g f c	2
agig	a g i g	2
fgehjh	f g e h j h	2
aga	a g a	2
jfii	j f i i	2
baj	b a j	2
jaheif	j a h e i f	2
edgch	e d g c h	2
bgiaifgb	b g i a i f g b	2
djffj	d j f f j	2
ecci	e c c i	2
hai	h a i	2
abgcf	a b g c f	2
jicff	j i c f f	2
cdfdc	c d f d c	2
gedfbi	g e d f b i	2
aaih	a a i h	2
ibehh	i b e h h	2
jcihi	j c i h i	2
iiiii	i i i i i	2
ddh	d d h	2
bafh	b a f h	2
ag	a g	2
aacgi	a a c g i	2
ddhffi	d d h f f i	2
aecf	a e c f	2
ibchc	i b c h c	2
gjhic	g j h i c	2
iid	i i d	2
ij	i j	2
baifi	b a i f i	2
cahc	c a h c	2
geih	g e i h	2
ahih	a h i h	2
aibb	a i b b	2
ghicf	g h i c f	2
decfief	d e c f i e f	2
hgcf	h g c f	2
abf	a b f	2
agj	a g j	2
fijh	f i j h	2
gjcc	g j c c	2
jceffji	j c e f f j i	2
gjghai	g j g h a i	2
diaci	d i a c i	2
acf	a c f	2
eifi	e i f i	2
ebija	e b i j a	2
abi	a b i	2
cfii	c f i i	2
fiji	f i j i	2
hgac	h g a c	2
cdfjcif	c d f j c i f	2
cjg	c j g	2
gjfah	g j f a h	2
dfhfdhji	d f h f d h j i	2
dei	d e i	2
agbf	a g b f	2
cee	c e e	2
eidi	e i d i	2
caf	c a f	2
ajehi	a j e h i	2
gidcab	g i d c a b	2
bdahg	b d a h g	2
ghbhghf	g h b h g h f	2
abc	a b c	2
jhfja	j h f j a	2
idcfehh	i d c f e h h	2
aegi	a e g i	2
bdf	b d f	2
iifbfi	i i f b f i	2
ahi	a h i	2
ahcef	a h c e f	2
faigbff	f a i g b f f	2
dfiih	d f i i h	2
ifja	i f j a	2
dfc	d f c	2
acaff	a c a f f	2
ac	a c	2
hfef	h f e f	2
fiajfbf	f i a j f b f	2
abb	a b b	2
ifgii	i f g i i	2
cjihj	c j i h j	2
dahihfh	d a h i h f h	2
dcif	d c i f	2
jbcfc	j b c f c	2
fiffi	f i f f i	2
bfh	b f h	2
cccc	c c c c	2
dbcf	d b c f	2
cfeiiij	c f e i i i j	2
fdbdgi	f d b d g i	2
edi	e d i	2
ihdfa	i h d f a	2
fefjij	f e f j i j	2
fbai	f b a i	2
cjhffij	c j h f f i j	2
cbifh	c b i f h	2
idhi	i d h i	2
chdibif	c h d i b i f	2
cgebi	c g e b i	2
dhagcc	d h a g c c	2
jibfh	j i b f h	2
aai	a a i	2
ibif	i b i f	2
chgef	c h g e f	2
fhfiic	f h f i i c	1
aejhj	a e j h j	1
jjciag	j j c i a g	1
eecc	e e c c	1
acicfj	a c i c f j	1
cai	c a i	1
gcibhf	g c i b h f	1
gabhc	g a b h c	1
jjhjf	j j h j f	1
fdb	f d b	1
gjbig	g j b i g	1
addfahh	a d d f a h h	1
bach	b a c h	1
cgii	c g i i	1
bdh	b d h	1
fbiic	f b i i c	1
gfjghchg	g f j g h c h g	1
jaihfgif	j a i h f g i f	1
ige	i g e	1
dbhi	d b h i	1
jedi	j e d i	1
ejbgcjf	e j b g c j f	1
ideeaf	i d e e a f	1
dfgf	d f g f	1
debhbh	d e b h b h	1
iccgh	i c c g h	1
aedb	a e d b	1
aedh	a e d h	1
dfbffh	d f b f f h	1
bejicgf	b e j i c g f	1
jjdigig	j j d i g i g	1
gdhjihcc	g d h j i h c c	1
gba	g b a	1
hfjga	h f j g a	1
fjde	f j d e	1
djgiih	d j g i i h	1
hadaf	h a d a f	1
jcifi	j c i f i	1
iicii	i i c i i	1
ihjc	i h j c	1
jdiech	j d i e c h	1
adhfh	a d h f h	1
aebgje	a e b g j e	1
jjhecie	j j h e c i e	1
fihghh	f i h g h h	1
bcif	b c i f	1
cdffafic	c d f f a f i c	1
egdf	e g d f	1
igihi	i g i h i	1
jhj	j h j	1
hfac	h f a c	1
fhf	f h f	1
gijihfc	g i j i h f c	1
bgific	b g i f i c	1
afbch	a f b c h	1
fiiai	f i i a i	1
gbi	g b i	1
idaeig	i d a e i g	1
dceiha	d c e i h a	1
ecg	e c g	1
eebf	e e b f	1
ffbbfc	f f b b f c	1
gdcdic	g d c d i c	1
dbbii	d b b i i	1
gcjhc	g c j h c	1
fdbfi	f d b f i	1
gaei	g a e i	1
djibefj	d j i b e f j	1
adhaf	a d h a f	1
idei	i d e i	1
cdbfbce	c d b f b c e	1
dhjfid	d h j f i d	1
cibiff	c i b i f f	1
afafh	a f a f h	1
jbeh	j b e h	1
bbhhjea	b b h h j e a	1
hgfbe	h g f b e	1
ghfgh	g h f g h	1
ggjbj	g g j b j	1
hcghha	h c g h h a	1
baafda	b a a f d a	1
fbbf	f b b f	1
iahhe	i a h h e	1
hghafhih	h g h a f h i h	1
dihhf	d i h h f	1
cief	c i e f	1
ajbh	a j b h	1
heijighc	h e i j i g h c	1
afei	a f e i	1
ihedi	i h e d i	1
biahf	b i a h f	1
ebgci	e b g c i	1
iicfh	i i c f h	1
fbhiaah	f b h i a a h	1
chcc	c h c c	1
dhbi	d h b i	1
diadfc	d i a d f c	1
hicc	h i c c	1
dddiii	d d d i i i	1
bjfhhi	b j f h h i	1
aefbcc	a e f b c c	1
igihj	i g i h j	1
jdff	j d f f	1
bdjehii	b d j e h i i	1
cdaidcf	c d a i d c f	1
ebeaaia	e b e a a i a	1
faea	f a e a	1
ifhdh	i f h d h	1
iagaj	i a g a j	1
aaj	a a j	1
adjga	a d j g a	1
bahhc	b a h h c	1
jadc	j a d c	1
gadiii	g a d i i i	1
egc	e g c	1
hbjhi	h b j h i	1
gaci	g a c i	1
fchichf	f c h i c h f	1
ggchf	g g c h f	1
ciahe	c i a h e	1
jbhfbh	j b h f b h	1
fbih	f b i h	1
afgh	a f g h	1
gfgh	g f g h	1
jjcicba	j j c i c b a	1
jdci	j d c i	1
bhfgjif	b h f g j i f	1
dficibc	d f i c i b c	1
agiea	a g i e a	1
bdijc	b d i j c	1
iea	i e a	1
ghchdf	g h c h d f	1
dda	d d a	1
adfii	a d f i i	1
jecdiaa	j e c d i a a	1
aifjfc	a i f j f c	1
iabf	i a b f	1
bfdhhcc	b f d h h c c	1
fbe	f b e	1
hbaefff	h b a e f f f	1
bgahi	b g a h i	1
adcch	a d c c h	1
baej	b a e j	1
ahhag	a h h a g	1
ahjjhh	a h j j h h	1
gbcdfe	g b c d f e	1
dcbffcc	d c b f f c c	1
ccdhih	c c d h i h	1
dbibhe	d b i b h e	1
ibbiad	i b b i a d	1
dgeia	d g e i a	1
ddie	d d i e	1
icaegi	i c a e g i	1
chg	c h g	1
heghjdcf	h e g h j d c f	1
bjehgi	b j e h g i	1
dfifh	d f i f h	1
cghf	c g h f	1
hcaif	h c a i f	1
fbhhf	f b h h f	1
cacif	c a c i f	1
aeicgi	a e i c g i	1
fiei	f i e i	1
ifah	i f a h	1
cbic	c b i c	1
hhhihei	h h h i h e i	1
ejadij	e j a d i j	1
ach	a c h	1
dbfhf	d b f h f	1
egcbja	e g c b j a	1
dbhh	d b h h	1
dhjaef	d h j a e f	1
jhfh	j h f h	1
agd	a g d	1
djiai	d j i a i	1
ighfcci	i g h f c c i	1
dfegf	d f e g f	1
ghjhiifi	g h j h i i f i	1
aeei	a e e i	1
abbgifhh	a b b g i f h h	1
ae	a e	1
ccbcj	c c b c j	1
hca	h c a	1
fih	f i h	1
aehia	a e h i a	1
fhfgif	f h f g i f	1
aif	a i f	1
dfdi	d f d i	1
bahbhf	b a h b h f	1
ibbfhba	i b b f h b a	1
aei	a e i	1
hdgc	h d g c	1
fbbh	f b b h	1
dhhfgch	d h h f g c h	1
ibcg	i b c g	1
acbj	a c b j	1
ecbiii	e c b i i i	1
dgfaei	d g f a e i	1
fecjifhb	f e c j i f h b	1
dbghd	d b g h d	1
eccc	e c c c	1
fhd	f h d	1
ggc	g g c	1
aic	a i c	1
hfei	h f e i	1
hhci	h h c i	1
idfcific	i d f c i f i c	1
dbihe	d b i h e	1
icfj	i c f j	1
jhchi	j h c h i	1
gigheg	g i g h e g	1
ajbhg	a j b h g	1
hcifh	h c i f h	1
bja	b j a	1
acjff	a c j f f	1
iebhi	i e b h i	1
adii	a d i i	1
ffch	f f c h	1
fghbf	f g h b f	1
fdfcbhih	f d f c b h i h	1
ifaif	i f a i f	1
ejihhf	e j i h h f	1
hgfjbhfg	h g f j b h f g	1
fhcfhf	f h c f h f	1
jjijjfh	j j i j j f h	1
hghdg	h g h d g	1
aacha	a a c h a	1
babddf	b a b d d f	1
gcdfgfi	g c d f g f i	1
cecii	c e c i i	1
ajbfeij	a j b f e i j	1
ggib	g g i b	1
fcach	f c a c h	1
ifdja	i f d j a	1
gccff	g c c f f	1
diifi	d i i f i	1
hgegbi	h g e g b i	1
dceeicch	d c e e i c c h	1
idih	i d i h	1
hbad	h b a d	1
ijff	i j f f	1
hfaifb	h f a i f b	1
giaih	g i a i h	1
eggfbif	e g g f b i f	1
fbcjhf	f b c j h f	1
ccahc	c c a h c	1
hecegfch	h e c e g f c h	1
ghae	g h a e	1
affaic	a f f a i c	1
aecijj	a e c i j j	1
bdcfc	b d c f c	1
gijdc	g i j d c	1
dieeff	d i e e f f	1
ceadhdh	c e a d h d h	1
fjhicg	f j h i c g	1
jccf	j c c f	1
fjcifb	f j c i f b	1
giha	g i h a	1
agiffha	a g i f f h a	1
cfji	c f j i	1
daihfb	d a i h f b	1
fiib	f i i b	1
adfi	a d f i	1
cedheii	c e d h e i i	1
debdi	d e b d i	1
dhihi	d h i h i	1
bihha	b i h h a	1
cfacii	c f a c i i	1
bcegii	b c e g i i	1
bdbig	b d b i g	1
aegii	a e g i i	1
fbci	f b c i	1
dhcfbi	d h c f b i	1
hdg	h d g	1
dga	d g a	1
chc	c h c	1
agdg	a g d g	1
ghihici	g h i h i c i	1
dfigh	d f i g h	1
cbfcf	c b f c f	1
ifjhef	i f j h e f	1
ebdahfif	e b d a h f i f	1
agbjhi	a g b j h i	1
idac	i d a c	1
jbhbjf	j b h b j f	1
dhcbhi	d h c b h i	1
dfiafh	d f i a f h	1
agcbgi	a g c b g i	1
cfaacii	c f a a c i i	1
bdbc	b d b c	1
cgdjfch	c g d j f c h	1
gfig	g f i g	1
jhjidja	j h j i d j a	1
cgdhd	c g d h d	1
hiiahec	h i i a h e c	1
habfhh	h a b f h h	1
cegii	c e g i i	1
baba	b a b a	1
aigd	a i g d	1
gfcif	g f c i f	1
iaaj	i a a j	1
eeb	e e b	1
ajhj	a j h j	1
jcf	j c f	1
ciiaa	c i i a a	1
gjeahj	g j e a h j	1
efchei	e f c h e i	1
gfbih	g f b i h	1
ghha	g h h a	1
dbdi	d b d i	1
fighh	f i g h h	1
ce	c e	1
dadhg	d a d h g	1
fcegfh	f c e g f h	1
gcghae	g c g h a e	1
baegi	b a e g i	1
cda	c d a	1
jiji	j i j i	1
chahi	c h a h i	1
hgifj	h g i f j	1
gcjfeb	g c j f e b	1
ffiifc	f f i i f c	1
eeidg	e e i d g	1
aheh	a h e h	1
bdijgfhf	b d i j g f h f	1
bdiigi	b d i i g i	1
jibh	j i b h	1
hbafiffb	h b a f i f f b	1
hgbbjif	h g b b j i f	1
ejcij	e j c i j	1
fcbfbi	f c b f b i	1
iiacdi	i i a c d i	1
ibeia	i b e i a	1
ejej	e j e j	1
hccf	h c c f	1
aeig	a e i g	1
jcci	j c c i	1
ejghf	e j g h f	1
bjaajc	b j a a j c	1
bfba	b f b a	1
gfiej	g f i e j	1
dgf	d g f	1
ebfa	e b f a	1
fbeiici	f b e i i c i	1
gged	g g e d	1
cadbeif	c a d b e i f	1
agghich	a g g h i c h	1
aadij	a a d i j	1
feegci	f e e g c i	1
gfche	g f c h e	1
dihh	d i h h	1
adfch	a d f c h	1
accgf	a c c g f	1
dacc	d a c c	1
cabaiij	c a b a i i j	1
fgja	f g j a	1
bfcai	b f c a i	1
bjid	b j i d	1
efifcaih	e f i f c a i h	1
iacj	i a c j	1
cgegh	c g e g h	1
eegf	e e g f	1
iihaa	i i h a a	1
dfdfh	d f d f h	1
fahdh	f a h d h	1
cfbf	c f b f	1
aaahei	a a a h e i	1
de	d e	1
bddff	b d d f f	1
aaaghi	a a a g h i	1
eeejhcj	e e e j h c j	1
bii	b i i	1
cejei	c e j e i	1
iaddi	i a d d i	1
ajei	a j e i	1
dgbghii	d g b g h i i	1
idfchbe	i d f c h b e	1
gabhcf	g a b h c f	1
dfgdic	d f g d i c	1
ficjjccd	f i c j j c c d	1
dhbch	d h b c h	1
jjj	j j j	1
gibgf	g i b g f	1
adig	a d i g	1
bhghi	b h g h i	1
dhccgi	d h c c g i	1
baehi	b a e h i	1
gcah	g c a h	1
cfic	c f i c	1
dgd	d g d	1
ceg	c e g	1
acgge	a c g g e	1
cghebj	c g h e b j	1
gdiffg	g d i f f g	1
jdjciii	j d j c i i i	1
checf	c h e c f	1
iefidfcf	i e f i d f c f	1
edfhcfi	e d f h c f i	1
gffjhah	g f f j h a h	1
hbhij	h b h i j	1
aiabaj	a i a b a j	1
ibaic	i b a i c	1
igabj	i g a b j	1
giigg	g i i g g	1
aheg	a h e g	1
hehia	h e h i a	1
cjjiif	c j j i i f	1
fdiibjh	f d i i b j h	1
bjdf	b j d f	1
efji	e f j i	1
ihibah	i h i b a h	1
cbgi	c b g i	1
bgai	b g a i	1
diff	d i f f	1
efbahff	e f b a h f f	1
cbgg	c b g g	1
cdjb	c d j b	1
ibah	i b a h	1
bd	b d	1
iiefc	i i e f c	1
ijeijii	i j e i j i i	1
gidaf	g i d a f	1
adhgf	a d h g f	1
ehcdh	e h c d h	1
fhdajii	f h d a j i i	1
bfabf	b f a b f	1
ijbgaj	i j b g a j	1
eea	e e a	1
jdhfgc	j d h f g c	1
igb	i g b	1
gce	g c e	1
aidfi	a i d f i	1
dihij	d i h i j	1
ddih	d d i h	1
chic	c h i c	1
cjffhfi	c j f f h f i	1
igcb	i g c b	1
gajgf	g a j g f	1
bbdh	b b d h	1
gjbfhgf	g j b f h g f	1
bajcechc	b a j c e c h c	1
cdifih	c d i f i h	1
bafe	b a f e	1
aacca	a a c c a	1
abbggeb	a b b g g e b	1
dfgag	d f g a g	1
iabhc	i a b h c	1
dhd	d h d	1
fgbb	f g b b	1
egah	e g a h	1
baaf	b a a f	1
bdahi	b d a h i	1
ijja	i j j a	1
dbf	d b f	1
bffeh	b f f e h	1
haaf	h a a f	1
bcgii	b c g i i	1
hdfj	h d f j	1
jjiia	j j i i a	1
bidi	b i d i	1
icidcch	i c i d c c h	1
hjh	h j h	1
jfhi	j f h i	1
dhhiifhi	d h h i i f h i	1
bgacij	b g a c i j	1
hiha	h i h a	1
ieijg	i e i j g	1
gdc	g d c	1
adh	a d h	1
eihg	e i h g	1
hbhdhfh	h b h d h f h	1
chjc	c h j c	1
gjiag	g j i a g	1
eigh	e i g h	1
bdbhbah	b d b h b a h	1
ffdha	f f d h a	1
haeeic	h a e e i c	1
gejci	g e j c i	1
gaf	g a f	1
fihh	f i h h	1
ijhhj	i j h h j	1
deghd	d e g h d	1
dfehah	d f e h a h	1
gffbhbhi	g f f b h b h i	1
hfa	h f a	1
bahhj	b a h h j	1
ddf	d d f	1
jhfac	j h f a c	1
hghi	h g h i	1
aia	a i a	1
fdjc	f d j c	1
gfedf	g f e d f	1
ahcii	a h c i i	1
agcfhja	a g c f h j a	1
ihgiia	i h g i i a	1
bfci	b f c i	1
dhh	d h h	1
deabhjei	d e a b h j e i	1
ehfi	e h f i	1
fdch	f d c h	1
jaa	j a a	1
afh	a f h	1
dhdiha	d h d i h a	1
gghghch	g g h g h c h	1
ejjieif	e j j i e i f	1
dii	d i i	1
aejfihc	a e j f i h c	1
baddh	b a d d h	1
hcbfihbj	h c b f i h b j	1
eaai	e a a i	1
hahce	h a h c e	1
jdgc	j d g c	1
diahfg	d i a h f g	1
hgid	h g i d	1
afhehh	a f h e h h	1
cha	c h a	1
gaggb	g a g g b	1
dhgafc	d h g a f c	1
fiba	f i b a	1
iij	i i j	1
bhhc	b h h c	1
fiehhi	f i e h h i	1
afai	a f a i	1
bea	b e a	1
fgagh	f g a g h	1
gageii	g a g e i i	1
ibhih	i b h i h	1
jbhh	j b h h	1
idbg	i d b g	1
dhac	d h a c	1
dahhf	d a h h f	1
ceaiif	c e a i i f	1
diiid	d i i i d	1
hjdficai	h j d f i c a i	1
igd	i g d	1
bfhcjca	b f h c j c a	1
fbggi	f b g g i	1
dhdchee	d h d c h e e	1
bae	b a e	1
dbhie	d b h i e	1
hhfbaijj	h h f b a i j j	1
efdhi	e f d h i	1
aeh	a e h	1
cgjfhhf	c g j f h h f	1
jjb	j j b	1
egifiij	e g i f i i j	1
gfcegc	g f c e g c	1
edjidc	e d j i d c	1
fahha	f a h h a	1
hgfhi	h g f h i	1
ijihc	i j i h c	1
hgjc	h g j c	1
ffjc	f f j c	1
aghhb	a g h h b	1
ahfhee	a h f h e e	1
ejfeihh	e j f e i h h	1
jiici	j i i c i	1
hdjiifi	h d j i i f i	1
gfgfiaa	g f g f i a a	1
cgc	c g c	1
iadif	i a d i f	1
db	d b	1
jffif	j f f i f	1
ahii	a h i i	1
adgci	a d g c i	1
fajfi	f a j f i	1
bab	b a b	1
gafii	g a f i i	1
dfeb	d f e b	1
cibaha	c i b a h a	1
dfgc	d f g c	1
dhag	d h a g	1
ijjacaca	i j j a c a c a	1
gbf	g b f	1
gdijgi	g d i j g i	1
bbcfi	b b c f i	1
agdfi	a g d f i	1
acfe	a c f e	1
cahic	c a h i c	1
cjcdd	c j c d d	1
babih	b a b i h	1
dcbhh	d c b h h	1
igdfjaf	i g d f j a f	1
jfe	j f e	1
gbjh	g b j h	1
hcecg	h c e c g	1
faff	f a f f	1
djjcfff	d j j c f f f	1
hfhh	h f h h	1
bdci	b d c i	1
iidhhhd	i i d h h h d	1
ihgdjhf	i h g d j h f	1
gf	g f	1
dcia	d c i a	1
fbjici	f b j i c i	1
fdjg	f d j g	1
aiaa	a i a a	1
dfei	d f e i	1
ejhdai	e j h d a i	1
aahfg	a a h f g	1
cgafehih	c g a f e h i h	1
iiahggi	i i a h g g i	1
dhfdj	d h f d j	1
gbc	g b c	1
ghigh	g h i g h	1
ahb	a h b	1
bdiag	b d i a g	1
fagb	f a g b	1
aficea	a f i c e a	1
jjg	j j g	1
bgdfii	b g d f i i	1
fhjgig	f h j g i g	1
dgidi	d g i d i	1
